纩	纩
鳖	鳖
异	异
静	静
崁	崁
熒	熒
鄲	鄲
飯	飯
瘢	瘢
烃	烃
馅	馅
期	期
賴	賴
槛	槛
匝	匝
喘	喘
壴	壴
耍	耍
枫	枫
舜	舜
良	良
吸	吸
戳	戳
峇	峇
稿	稿
鸱	鸱
溻	溻
逋	逋
妡	妡
镤	镤
讽	讽
垧	垧
紮	紮
説	説
償	償
锹	锹
鉚	鉚
珐	珐
怔	怔
玖	玖
惦	惦
檔	檔
苷	苷
瓒	瓒
気	気
證	證
鎛	鎛
阜	阜
戒	戒
俑	俑
伕	伕
橙	橙
骄	骄
湟	湟
鋪	鋪
邽	邽
浩	浩
緹	緹
朧	朧
建	建
蟠	蟠
逾	逾
出	出
朋	朋
讠	讠
亂	亂
寧	寧
禱	禱
聴	聴
揠	揠
蝦	蝦
钽	钽
藏	藏
彻	彻
劍	劍
阕	阕
厥	厥
倩	倩
鲵	鲵
酝	酝
绘	绘
櫸	櫸
攏	攏
缰	缰
靴	靴
榆	榆
踵	踵
涡	涡
潞	潞
旒	旒
吳	吳
功	功
觊	觊
湣	湣
吗	吗
就	就
狗	狗
孜	孜
漂	漂
鎉	鎉
裙	裙
驺	驺
厢	厢
址	址
饍	饍
兄	兄
蓓	蓓
沧	沧
净	净
橛	橛
热	热
腥	腥
峭	峭
缽	缽
虐	虐
锟	锟
缨	缨
闢	闢
攪	攪
妨	妨
复	复
敛	敛
诏	诏
場	場
恕	恕
馔	馔
艘	艘
饯	饯
伤	伤
怏	怏
瑞	瑞
沅	沅
耘	耘
萋	萋
腧	腧
灘	灘
亲	亲
汜	汜
鸥	鸥
肠	肠
尔	尔
通	通
缈	缈
胀	胀
窨	窨
肄	肄
萬	萬
闾	闾
璎	璎
琨	琨
赟	赟
踏	踏
彦	彦
驟	驟
碥	碥
庶	庶
埭	埭
懋	懋
降	降
镝	镝
减	减
陷	陷
泻	泻
案	案
抵	抵
冫	冫
峰	峰
损	损
瘦	瘦
增	增
殲	殲
糍	糍
臀	臀
凤	凤
卿	卿
籲	籲
祝	祝
吡	吡
欲	欲
作	作
樋	樋
涮	涮
髽	髽
北	北
菖	菖
郵	郵
厶	厶
脫	脫
盯	盯
荷	荷
聲	聲
哗	哗
桧	桧
岔	岔
妲	妲
脏	脏
婧	婧
肇	肇
鎔	鎔
怆	怆
轍	轍
伞	伞
馄	馄
渾	渾
会	会
瘊	瘊
奣	奣
燊	燊
屠	屠
屆	屆
缗	缗
甯	甯
更	更
篦	篦
阈	阈
始	始
熵	熵
阝	阝
蚿	蚿
幄	幄
簍	簍
园	园
岀	岀
窕	窕
爿	爿
惠	惠
勵	勵
悍	悍
巒	巒
站	站
淹	淹
疝	疝
締	締
馭	馭
萄	萄
憊	憊
猞	猞
逮	逮
畲	畲
坷	坷
閤	閤
肺	肺
讹	讹
刀	刀
醴	醴
败	败
甾	甾
撃	撃
轸	轸
舅	舅
殒	殒
锢	锢
垴	垴
護	護
妆	妆
镟	镟
若	若
搅	搅
削	削
惨	惨
見	見
搀	搀
拴	拴
她	她
板	板
尸	尸
威	威
比	比
粽	粽
婴	婴
夙	夙
才	才
酯	酯
禧	禧
夔	夔
漸	漸
泛	泛
淄	淄
俛	俛
峩	峩
久	久
蠕	蠕
戗	戗
佢	佢
褥	褥
唻	唻
遑	遑
訁	訁
尖	尖
碗	碗
烩	烩
稅	稅
嘛	嘛
桷	桷
蕉	蕉
糅	糅
葚	葚
堙	堙
抻	抻
钤	钤
鹵	鹵
诰	诰
章	章
増	増
慈	慈
璇	璇
麩	麩
擔	擔
溯	溯
肉	肉
肆	肆
砍	砍
嗶	嗶
粟	粟
恝	恝
剎	剎
跽	跽
构	构
绿	绿
璐	璐
嵂	嵂
铂	铂
箋	箋
錳	錳
撓	撓
霉	霉
螯	螯
纔	纔
毙	毙
展	展
潮	潮
钴	钴
詩	詩
莞	莞
舸	舸
罃	罃
躁	躁
莢	莢
耜	耜
籬	籬
曾	曾
掏	掏
資	資
養	養
邘	邘
測	測
郴	郴
錘	錘
赡	赡
炉	炉
探	探
绸	绸
絵	絵
慚	慚
知	知
貽	貽
輯	輯
榕	榕
琐	琐
翹	翹
漕	漕
賬	賬
听	听
捻	捻
勸	勸
劃	劃
邕	邕
肱	肱
鏢	鏢
疬	疬
婪	婪
竄	竄
労	労
纨	纨
妗	妗
馍	馍
瞥	瞥
揶	揶
談	談
瞼	瞼
蟪	蟪
蕖	蕖
遞	遞
傀	傀
焚	焚
麼	麼
怒	怒
谁	谁
叔	叔
銖	銖
廨	廨
甥	甥
迸	迸
购	购
徭	徭
喵	喵
焘	焘
斫	斫
愠	愠
铁	铁
骗	骗
匯	匯
撂	撂
費	費
猲	猲
形	形
榈	榈
靦	靦
鸠	鸠
恋	恋
壩	壩
閃	閃
啃	啃
鲀	鲀
呙	呙
磊	磊
蜜	蜜
漪	漪
琦	琦
懷	懷
植	植
守	守
性	性
拮	拮
戀	戀
熏	熏
阊	阊
胥	胥
筊	筊
滥	滥
携	携
皕	皕
追	追
麗	麗
嘣	嘣
汕	汕
纫	纫
飞	飞
涠	涠
胡	胡
亟	亟
姆	姆
匾	匾
禺	禺
邂	邂
雋	雋
又	又
潛	潛
坍	坍
酃	酃
葩	葩
賈	賈
獒	獒
蘊	蘊
安	安
蝴	蝴
飨	飨
鬱	鬱
粒	粒
鯛	鯛
铨	铨
擴	擴
螂	螂
旴	旴
淀	淀
蛋	蛋
鯨	鯨
永	永
苗	苗
柒	柒
詬	詬
柩	柩
肴	肴
刎	刎
茵	茵
烘	烘
侮	侮
锣	锣
傻	傻
薜	薜
霾	霾
誌	誌
湫	湫
贾	贾
簾	簾
姍	姍
泄	泄
娅	娅
妒	妒
笪	笪
黼	黼
潍	潍
癮	癮
辰	辰
嘆	嘆
脸	脸
耒	耒
腕	腕
诙	诙
墪	墪
靄	靄
歃	歃
閲	閲
乏	乏
汶	汶
所	所
薛	薛
埯	埯
恬	恬
溅	溅
蜻	蜻
山	山
周	周
砾	砾
勝	勝
隐	隐
訝	訝
垚	垚
饺	饺
秸	秸
逅	逅
侃	侃
劏	劏
簸	簸
伉	伉
口	口
媚	媚
婄	婄
赓	赓
薄	薄
嵨	嵨
另	另
氖	氖
彝	彝
問	問
螟	螟
款	款
杼	杼
騴	騴
杜	杜
榷	榷
环	环
炫	炫
渴	渴
揿	揿
栎	栎
够	够
吏	吏
脘	脘
跛	跛
則	則
规	规
艦	艦
揄	揄
笮	笮
苹	苹
都	都
霑	霑
佰	佰
純	純
矾	矾
颦	颦
蹒	蹒
界	界
謙	謙
汹	汹
赳	赳
班	班
鬐	鬐
嗔	嗔
懿	懿
運	運
他	他
蒹	蒹
漣	漣
舾	舾
効	効
呦	呦
泥	泥
廬	廬
蚋	蚋
鉗	鉗
丁	丁
础	础
殤	殤
湳	湳
马	马
嬉	嬉
骡	骡
幻	幻
斬	斬
焉	焉
倏	倏
茬	茬
飘	飘
彘	彘
琺	琺
许	许
纯	纯
怂	怂
拨	拨
峽	峽
鉀	鉀
梶	梶
蠨	蠨
抱	抱
転	転
艳	艳
蹄	蹄
辦	辦
匐	匐
缵	缵
啧	啧
肛	肛
钵	钵
进	进
幢	幢
欒	欒
暹	暹
渙	渙
百	百
顷	顷
枱	枱
关	关
咯	咯
岸	岸
荣	荣
造	造
侏	侏
祢	祢
荼	荼
铬	铬
屎	屎
满	满
蛟	蛟
薨	薨
咳	咳
驢	驢
獷	獷
旅	旅
莉	莉
虻	虻
類	類
鉏	鉏
漯	漯
朐	朐
灞	灞
帶	帶
闔	闔
甲	甲
撮	撮
鞶	鞶
沖	沖
挎	挎
堂	堂
宛	宛
颗	颗
崔	崔
煌	煌
紓	紓
翰	翰
闪	闪
凱	凱
顏	顏
皇	皇
钎	钎
徉	徉
犹	犹
蒯	蒯
冇	冇
昆	昆
時	時
健	健
胪	胪
祧	祧
残	残
匍	匍
舖	舖
斐	斐
桿	桿
锤	锤
獵	獵
訶	訶
晋	晋
蚤	蚤
嗣	嗣
興	興
剁	剁
煩	煩
鶘	鶘
譯	譯
辜	辜
雞	雞
龛	龛
狞	狞
忘	忘
箫	箫
櫻	櫻
司	司
踯	踯
勤	勤
疟	疟
搭	搭
茈	茈
蟳	蟳
嗽	嗽
轰	轰
旎	旎
糬	糬
呐	呐
户	户
仪	仪
憚	憚
圃	圃
蝇	蝇
瀨	瀨
自	自
爰	爰
烈	烈
贡	贡
膾	膾
伐	伐
铣	铣
岐	岐
慢	慢
咒	咒
刚	刚
霧	霧
摧	摧
荔	荔
蕭	蕭
印	印
辯	辯
冰	冰
剂	剂
臘	臘
气	气
举	举
輸	輸
玹	玹
沄	沄
还	还
卑	卑
八	八
損	損
弃	弃
迹	迹
簫	簫
暾	暾
憨	憨
許	許
鹃	鹃
籼	籼
晻	晻
鉴	鉴
藿	藿
俏	俏
瀋	瀋
铙	铙
韶	韶
拡	拡
黃	黃
蕊	蕊
舂	舂
廟	廟
叵	叵
锶	锶
交	交
喇	喇
俅	俅
異	異
啊	啊
買	買
凳	凳
珣	珣
占	占
躊	躊
侂	侂
秤	秤
飓	飓
菱	菱
谈	谈
摸	摸
脱	脱
铸	铸
粉	粉
惫	惫
芪	芪
睥	睥
仕	仕
儘	儘
榧	榧
崭	崭
銜	銜
惱	惱
捅	捅
狂	狂
貫	貫
鄄	鄄
屈	屈
芾	芾
蒋	蒋
妈	妈
验	验
衣	衣
密	密
铿	铿
齁	齁
嵘	嵘
谛	谛
已	已
绪	绪
慎	慎
纠	纠
下	下
嵗	嵗
妾	妾
鱔	鱔
魔	魔
春	春
沉	沉
渗	渗
靡	靡
艇	艇
谬	谬
跄	跄
顼	顼
苣	苣
胖	胖
媖	媖
扃	扃
級	級
飙	飙
阋	阋
飲	飲
煽	煽
糙	糙
委	委
钣	钣
瘅	瘅
塄	塄
嘍	嘍
鷩	鷩
逊	逊
萧	萧
攫	攫
勇	勇
褡	褡
万	万
嶺	嶺
謄	謄
崂	崂
埤	埤
舌	舌
窒	窒
鐸	鐸
寐	寐
捌	捌
绎	绎
栈	栈
温	温
幸	幸
樁	樁
薳	薳
惭	惭
掷	掷
鑲	鑲
搞	搞
鸯	鸯
浑	浑
窮	窮
躍	躍
芝	芝
唯	唯
罄	罄
玄	玄
杷	杷
淨	淨
麵	麵
暢	暢
惩	惩
応	応
磕	磕
舺	舺
獭	獭
儿	儿
摳	摳
圹	圹
掮	掮
张	张
沪	沪
姒	姒
閡	閡
娆	娆
領	領
词	词
圧	圧
淌	淌
硯	硯
泊	泊
呺	呺
挫	挫
诳	诳
抬	抬
來	來
肮	肮
撼	撼
翊	翊
爬	爬
号	号
吽	吽
锄	锄
溴	溴
祠	祠
砦	砦
芭	芭
狹	狹
隻	隻
牯	牯
寬	寬
锱	锱
泌	泌
欤	欤
邯	邯
佘	佘
璽	璽
荽	荽
僻	僻
紋	紋
輿	輿
琯	琯
拇	拇
钚	钚
妥	妥
谤	谤
偌	偌
綑	綑
篱	篱
嬸	嬸
掐	掐
誕	誕
睽	睽
兩	兩
頸	頸
秋	秋
焕	焕
拌	拌
汤	汤
橱	橱
嗳	嗳
钹	钹
伟	伟
洗	洗
廳	廳
魅	魅
秦	秦
疔	疔
苕	苕
厦	厦
霖	霖
肽	肽
斱	斱
愛	愛
緁	緁
騪	騪
折	折
瞟	瞟
擺	擺
鱉	鱉
驳	驳
闕	闕
貶	貶
樸	樸
棁	棁
屏	屏
似	似
谝	谝
捺	捺
质	质
浮	浮
沓	沓
滯	滯
砜	砜
辐	辐
嗤	嗤
胝	胝
孫	孫
卡	卡
卍	卍
添	添
儼	儼
沒	沒
殘	殘
艺	艺
噼	噼
蛆	蛆
此	此
糖	糖
饲	饲
潟	潟
繹	繹
髮	髮
躇	躇
泮	泮
羁	羁
诊	诊
窟	窟
梓	梓
撐	撐
査	査
壘	壘
潤	潤
缭	缭
氛	氛
粿	粿
鎗	鎗
确	确
溃	溃
節	節
皝	皝
腹	腹
響	響
几	几
跨	跨
婁	婁
兢	兢
鉤	鉤
魚	魚
疑	疑
憎	憎
扬	扬
硚	硚
心	心
貢	貢
踝	踝
椋	椋
焱	焱
冲	冲
粱	粱
受	受
蠣	蠣
擀	擀
紙	紙
齊	齊
谦	谦
国	国
默	默
洹	洹
覇	覇
涨	涨
苻	苻
龚	龚
终	终
毎	毎
疹	疹
娲	娲
幣	幣
逸	逸
禿	禿
蜥	蜥
皚	皚
微	微
箦	箦
廛	廛
笋	笋
勧	勧
涟	涟
据	据
鄭	鄭
宠	宠
廷	廷
匈	匈
鲧	鲧
隊	隊
蛾	蛾
效	效
靚	靚
鮑	鮑
魟	魟
痊	痊
霊	霊
偶	偶
抹	抹
曙	曙
陉	陉
膨	膨
祷	祷
筠	筠
茌	茌
垱	垱
纭	纭
汗	汗
汩	汩
陨	陨
販	販
粹	粹
饰	饰
佶	佶
鱈	鱈
袤	袤
盔	盔
縱	縱
简	简
囝	囝
竟	竟
樽	樽
阔	阔
瑗	瑗
藔	藔
享	享
索	索
舍	舍
伊	伊
鸩	鸩
騰	騰
堪	堪
沽	沽
镗	镗
弔	弔
瘫	瘫
繋	繋
沦	沦
归	归
吹	吹
赐	赐
妄	妄
隙	隙
阀	阀
腺	腺
峄	峄
黹	黹
鲖	鲖
顴	顴
绂	绂
既	既
跳	跳
扫	扫
聽	聽
嶙	嶙
哺	哺
駆	駆
舢	舢
藓	藓
皂	皂
鼯	鼯
血	血
培	培
忽	忽
手	手
恙	恙
榛	榛
衙	衙
樯	樯
誰	誰
玩	玩
戌	戌
雒	雒
冱	冱
凇	凇
掴	掴
轳	轳
椵	椵
嘟	嘟
鈕	鈕
份	份
稷	稷
蟒	蟒
奮	奮
単	単
縴	縴
泉	泉
渠	渠
韧	韧
衰	衰
嫻	嫻
珺	珺
旁	旁
蛄	蛄
塵	塵
蓥	蓥
凹	凹
苜	苜
门	门
皆	皆
设	设
茹	茹
拥	拥
殖	殖
给	给
裳	裳
噩	噩
毅	毅
糧	糧
潆	潆
投	投
捞	捞
昊	昊
氨	氨
羊	羊
蠶	蠶
專	專
难	难
阬	阬
速	速
麈	麈
啂	啂
俘	俘
琊	琊
跼	跼
硕	硕
廁	廁
鋆	鋆
順	順
鲛	鲛
氧	氧
氲	氲
党	党
瘴	瘴
涵	涵
澍	澍
葳	葳
指	指
眦	眦
雳	雳
煦	煦
讳	讳
詐	詐
津	津
莙	莙
篥	篥
邴	邴
势	势
鹼	鹼
尝	尝
氈	氈
粳	粳
碼	碼
历	历
蓖	蓖
極	極
氮	氮
尚	尚
挲	挲
婊	婊
埚	埚
傚	傚
歇	歇
你	你
弟	弟
翱	翱
林	林
刽	刽
滝	滝
輩	輩
帜	帜
聆	聆
歆	歆
縣	縣
枨	枨
绮	绮
圓	圓
鉄	鉄
礴	礴
罢	罢
暐	暐
定	定
盖	盖
姣	姣
蜂	蜂
身	身
濟	濟
邸	邸
痤	痤
杂	杂
促	促
润	润
有	有
緯	緯
鹘	鹘
兰	兰
伪	伪
狽	狽
巴	巴
攥	攥
購	購
綵	綵
入	入
勒	勒
鄮	鄮
尾	尾
墉	墉
憤	憤
韋	韋
干	干
也	也
阉	阉
借	借
裤	裤
矍	矍
饷	饷
垡	垡
隽	隽
晊	晊
倚	倚
濒	濒
子	子
駁	駁
喳	喳
緞	緞
瘌	瘌
覃	覃
諾	諾
應	應
酢	酢
乳	乳
疊	疊
閣	閣
爪	爪
込	込
冠	冠
火	火
昔	昔
琵	琵
吒	吒
烯	烯
蹲	蹲
擒	擒
利	利
韩	韩
鱸	鱸
玟	玟
賁	賁
跎	跎
鮨	鮨
迤	迤
轱	轱
結	結
層	層
宸	宸
乩	乩
汪	汪
缜	缜
突	突
丟	丟
抛	抛
魋	魋
洁	洁
弯	弯
涣	涣
垠	垠
承	承
慶	慶
赘	赘
觥	觥
食	食
矽	矽
亢	亢
麒	麒
霍	霍
琶	琶
剋	剋
缚	缚
髋	髋
瑤	瑤
铩	铩
葦	葦
决	决
帳	帳
怪	怪
吆	吆
鞍	鞍
越	越
驰	驰
荧	荧
脅	脅
険	険
號	號
嫦	嫦
苳	苳
隼	隼
瞓	瞓
綏	綏
瞋	瞋
峙	峙
篌	篌
晗	晗
喙	喙
巖	巖
呃	呃
杈	杈
拯	拯
蔚	蔚
仫	仫
阻	阻
歼	歼
堌	堌
蘅	蘅
筱	筱
献	献
让	让
厔	厔
苟	苟
雷	雷
晚	晚
虾	虾
酋	酋
蜡	蜡
癡	癡
給	給
祓	祓
碑	碑
渲	渲
嵌	嵌
侗	侗
拭	拭
陇	陇
虞	虞
罡	罡
庙	庙
泷	泷
眙	眙
尧	尧
沙	沙
藕	藕
淺	淺
湓	湓
語	語
箜	箜
瓴	瓴
喊	喊
寻	寻
僧	僧
蓟	蓟
埈	埈
矸	矸
槎	槎
第	第
菜	菜
澴	澴
致	致
潢	潢
眸	眸
赁	赁
级	级
伙	伙
两	两
囵	囵
璨	璨
倪	倪
催	催
碲	碲
嶝	嶝
扔	扔
丛	丛
鹪	鹪
走	走
姝	姝
写	写
搗	搗
鹧	鹧
璀	璀
跸	跸
品	品
邰	邰
溍	溍
医	医
罟	罟
帽	帽
壊	壊
聶	聶
旷	旷
碁	碁
峯	峯
掼	掼
瘾	瘾
懼	懼
蒻	蒻
蕈	蕈
劻	劻
厌	厌
澥	澥
聒	聒
羥	羥
狍	狍
朮	朮
琪	琪
怜	怜
笊	笊
驍	驍
毖	毖
顆	顆
痕	痕
佳	佳
墘	墘
潸	潸
皴	皴
惰	惰
督	督
旸	旸
鹉	鹉
骠	骠
翃	翃
驽	驽
桓	桓
埜	埜
倻	倻
途	途
戾	戾
咚	咚
晕	晕
虎	虎
璉	璉
瘋	瘋
耳	耳
颜	颜
熄	熄
哧	哧
継	継
兖	兖
蹈	蹈
怛	怛
废	废
韌	韌
寝	寝
翟	翟
萃	萃
溱	溱
卜	卜
嘬	嘬
殡	殡
厳	厳
忧	忧
符	符
為	為
敌	敌
娛	娛
毕	毕
蹣	蹣
鎧	鎧
盁	盁
鹳	鹳
凪	凪
庫	庫
羨	羨
婆	婆
澧	澧
淤	淤
桔	桔
蛮	蛮
珏	珏
衮	衮
烦	烦
拓	拓
刁	刁
茗	茗
元	元
缕	缕
苓	苓
孟	孟
邋	邋
劫	劫
转	转
谍	谍
箪	箪
苍	苍
剜	剜
钌	钌
诌	诌
夷	夷
暎	暎
郕	郕
铲	铲
炸	炸
壶	壶
犯	犯
烟	烟
鞴	鞴
蛔	蛔
囪	囪
窘	窘
魉	魉
呶	呶
誤	誤
玘	玘
齡	齡
囤	囤
挛	挛
発	発
方	方
榴	榴
菲	菲
崩	崩
荪	荪
莖	莖
踬	踬
蛎	蛎
霰	霰
辺	辺
碟	碟
遶	遶
繞	繞
纷	纷
蜢	蜢
迥	迥
丰	丰
荒	荒
遜	遜
辻	辻
墳	墳
锦	锦
忑	忑
啵	啵
狭	狭
僳	僳
掠	掠
楊	楊
东	东
巾	巾
疏	疏
太	太
愚	愚
擲	擲
珰	珰
贤	贤
飽	飽
鄰	鄰
振	振
懂	懂
炙	炙
谘	谘
惇	惇
畹	畹
烷	烷
戰	戰
唠	唠
锉	锉
毓	毓
氏	氏
荡	荡
娑	娑
缯	缯
庾	庾
辇	辇
对	对
鹌	鹌
讨	讨
閒	閒
柴	柴
髓	髓
污	污
耙	耙
犬	犬
燼	燼
譴	譴
叠	叠
豌	豌
犧	犧
郃	郃
棉	棉
港	港
虬	虬
哙	哙
粤	粤
鑽	鑽
鵡	鵡
嗰	嗰
脚	脚
钻	钻
侴	侴
選	選
卮	卮
朔	朔
瞻	瞻
卉	卉
依	依
嬪	嬪
徙	徙
芍	芍
諱	諱
鹔	鹔
溫	溫
裂	裂
扱	扱
噫	噫
鶯	鶯
觱	觱
卅	卅
遘	遘
魑	魑
褂	褂
颛	颛
续	续
輾	輾
纵	纵
箾	箾
酆	酆
副	副
幌	幌
跡	跡
莱	莱
戮	戮
轴	轴
禀	禀
针	针
虹	虹
渐	渐
蠲	蠲
噘	噘
乗	乗
翻	翻
蚣	蚣
噢	噢
徹	徹
傳	傳
現	現
棰	棰
唾	唾
驾	驾
力	力
帚	帚
彈	彈
伃	伃
蔑	蔑
溪	溪
讚	讚
辈	辈
産	産
偪	偪
惚	惚
瀬	瀬
临	临
滩	滩
本	本
嗯	嗯
粼	粼
犷	犷
坭	坭
復	復
衆	衆
辗	辗
歔	歔
術	術
调	调
镶	镶
缆	缆
瑄	瑄
杳	杳
緘	緘
餡	餡
鬥	鬥
肏	肏
癥	癥
陀	陀
滹	滹
遲	遲
谌	谌
檀	檀
磻	磻
軾	軾
廠	廠
阪	阪
荊	荊
癫	癫
郡	郡
嗝	嗝
慣	慣
邙	邙
楀	楀
弁	弁
鮮	鮮
喜	喜
跑	跑
附	附
傥	傥
撷	撷
辫	辫
短	短
拍	拍
厲	厲
嗓	嗓
撩	撩
趕	趕
叨	叨
據	據
术	术
賣	賣
籓	籓
弢	弢
淛	淛
慕	慕
销	销
毹	毹
鸲	鸲
慑	慑
咤	咤
囗	囗
魁	魁
咨	咨
忱	忱
嘮	嘮
氷	氷
耶	耶
牖	牖
鲈	鲈
狮	狮
舊	舊
绯	绯
縡	縡
罪	罪
撤	撤
紀	紀
屯	屯
彼	彼
钱	钱
枲	枲
補	補
妧	妧
棕	棕
啷	啷
蓼	蓼
同	同
戡	戡
縁	縁
龔	龔
辋	辋
嵎	嵎
該	該
荏	荏
紊	紊
舄	舄
瑶	瑶
蒴	蒴
磬	磬
疣	疣
飄	飄
烙	烙
啓	啓
緣	緣
击	击
曦	曦
燿	燿
蝉	蝉
滕	滕
坳	坳
梵	梵
彆	彆
晦	晦
蜑	蜑
益	益
漬	漬
逕	逕
紜	紜
计	计
嘁	嘁
訟	訟
襄	襄
炜	炜
氐	氐
甦	甦
斧	斧
捜	捜
骜	骜
勁	勁
鍍	鍍
豪	豪
忆	忆
詰	詰
嬗	嬗
疥	疥
竖	竖
钉	钉
矛	矛
铆	铆
率	率
緋	緋
紐	紐
呜	呜
寥	寥
旦	旦
塽	塽
襶	襶
滂	滂
大	大
欽	欽
蘸	蘸
殄	殄
歹	歹
邵	邵
嫘	嫘
貨	貨
陣	陣
桯	桯
饿	饿
鳗	鳗
欺	欺
持	持
陆	陆
灵	灵
蘋	蘋
裉	裉
说	说
臟	臟
砷	砷
睞	睞
欠	欠
衝	衝
院	院
猙	猙
悆	悆
绦	绦
砺	砺
啱	啱
鋸	鋸
暄	暄
吖	吖
寄	寄
銘	銘
脯	脯
锈	锈
饅	饅
钠	钠
沭	沭
戚	戚
营	营
昼	昼
蝣	蝣
鸾	鸾
链	链
貳	貳
躏	躏
蛏	蛏
伸	伸
嚴	嚴
瑙	瑙
乖	乖
砥	砥
表	表
嵒	嵒
遼	遼
辙	辙
篓	篓
萵	萵
畔	畔
緒	緒
踮	踮
栽	栽
觌	觌
伏	伏
滅	滅
三	三
晾	晾
鳯	鳯
絨	絨
溝	溝
汇	汇
甭	甭
監	監
缸	缸
燕	燕
鹭	鹭
绍	绍
渭	渭
摒	摒
赇	赇
榫	榫
鞅	鞅
黏	黏
碶	碶
惑	惑
浙	浙
圯	圯
谊	谊
譚	譚
掛	掛
連	連
疼	疼
修	修
遇	遇
曉	曉
鷺	鷺
莊	莊
喈	喈
饨	饨
膑	膑
获	获
些	些
氯	氯
名	名
劼	劼
奄	奄
尻	尻
荅	荅
顺	顺
釐	釐
苏	苏
童	童
浏	浏
觑	觑
拽	拽
骛	骛
眯	眯
闌	闌
蟻	蟻
炘	炘
捭	捭
愣	愣
弈	弈
瑾	瑾
疎	疎
劈	劈
跟	跟
兇	兇
枉	枉
辽	辽
鑒	鑒
咛	咛
藍	藍
蟬	蟬
铛	铛
雇	雇
踅	踅
醮	醮
続	続
炖	炖
游	游
池	池
截	截
娶	娶
秣	秣
絮	絮
塾	塾
钞	钞
札	札
其	其
易	易
鑄	鑄
箐	箐
辄	辄
尉	尉
玦	玦
诫	诫
郦	郦
柱	柱
芑	芑
豢	豢
午	午
狒	狒
晝	晝
鯉	鯉
嚀	嚀
学	学
酮	酮
慟	慟
銑	銑
茎	茎
扦	扦
儀	儀
驥	驥
讷	讷
后	后
珈	珈
木	木
乂	乂
齮	齮
铖	铖
纂	纂
洞	洞
碾	碾
礼	礼
謇	謇
采	采
袆	袆
丙	丙
由	由
刍	刍
員	員
亿	亿
髅	髅
醉	醉
纳	纳
运	运
嗜	嗜
橋	橋
漆	漆
删	删
沢	沢
升	升
革	革
掲	掲
渤	渤
休	休
愔	愔
咄	咄
篑	篑
怿	怿
躉	躉
剣	剣
懔	懔
競	競
佑	佑
染	染
岬	岬
營	營
癌	癌
恻	恻
稺	稺
鳄	鳄
嘴	嘴
省	省
怨	怨
冏	冏
耋	耋
噠	噠
舎	舎
憙	憙
珀	珀
映	映
必	必
疙	疙
踩	踩
倔	倔
鋰	鋰
鲟	鲟
穢	穢
曲	曲
媞	媞
鎬	鎬
饗	饗
嗑	嗑
逵	逵
泵	泵
靠	靠
绶	绶
騜	騜
贊	贊
骘	骘
光	光
铡	铡
翔	翔
嘈	嘈
踪	踪
島	島
胍	胍
孚	孚
型	型
闿	闿
册	册
桫	桫
迺	迺
叟	叟
鉅	鉅
输	输
絶	絶
蠻	蠻
縮	縮
姉	姉
孃	孃
魘	魘
剽	剽
醒	醒
恤	恤
雪	雪
剧	剧
蒜	蒜
薯	薯
戛	戛
冼	冼
區	區
婺	婺
骇	骇
老	老
伧	伧
葺	葺
然	然
奘	奘
閘	閘
疖	疖
岘	岘
徳	徳
氡	氡
练	练
庇	庇
龠	龠
姗	姗
鸮	鸮
槻	槻
腦	腦
漢	漢
争	争
骥	骥
槓	槓
侓	侓
滋	滋
吞	吞
檬	檬
球	球
砣	砣
醯	醯
直	直
垦	垦
鹎	鹎
沼	沼
艾	艾
萎	萎
髁	髁
闯	闯
体	体
乍	乍
關	關
載	載
勳	勳
葛	葛
笸	笸
赈	赈
互	互
廆	廆
袢	袢
娜	娜
羅	羅
礽	礽
菽	菽
毒	毒
薅	薅
洮	洮
輓	輓
臕	臕
饴	饴
遙	遙
餓	餓
吶	吶
瀆	瀆
柰	柰
庁	庁
坻	坻
鸨	鸨
蕻	蕻
乾	乾
焯	焯
黍	黍
嶼	嶼
鱗	鱗
鹿	鹿
慄	慄
去	去
筅	筅
駐	駐
握	握
苒	苒
間	間
厉	厉
稗	稗
撑	撑
佇	佇
鏖	鏖
酪	酪
房	房
晶	晶
渍	渍
惘	惘
敖	敖
养	养
怵	怵
崑	崑
棨	棨
敕	敕
连	连
畈	畈
烹	烹
燙	燙
独	独
蚜	蚜
劉	劉
杏	杏
晖	晖
輀	輀
縷	縷
鄺	鄺
栋	栋
买	买
硬	硬
抑	抑
颯	颯
囹	囹
帷	帷
噗	噗
抢	抢
啟	啟
績	績
垂	垂
瞞	瞞
柢	柢
逶	逶
撻	撻
竣	竣
飼	飼
髻	髻
銳	銳
俪	俪
旬	旬
征	征
涪	涪
摇	摇
蔻	蔻
骓	骓
示	示
宇	宇
帀	帀
诮	诮
歳	歳
呋	呋
颱	颱
鞋	鞋
臾	臾
盈	盈
蓦	蓦
峋	峋
蒑	蒑
递	递
檄	檄
謩	謩
勋	勋
锻	锻
拿	拿
冥	冥
灣	灣
茧	茧
且	且
拣	拣
寮	寮
頹	頹
識	識
尿	尿
驶	驶
遐	遐
囔	囔
蚱	蚱
膜	膜
諳	諳
尥	尥
梅	梅
浔	浔
凈	凈
蕪	蕪
阚	阚
祊	祊
濫	濫
屐	屐
貅	貅
褧	褧
弒	弒
漁	漁
和	和
視	視
筲	筲
揚	揚
顯	顯
賦	賦
舞	舞
鄱	鄱
腚	腚
裱	裱
祕	祕
诩	诩
鲅	鲅
畀	畀
慉	慉
淯	淯
订	订
馒	馒
漱	漱
垮	垮
聰	聰
黒	黒
鍛	鍛
蹇	蹇
弄	弄
邳	邳
薩	薩
纹	纹
劲	劲
當	當
檎	檎
笈	笈
逢	逢
辣	辣
僭	僭
埔	埔
釁	釁
臍	臍
鹕	鹕
乃	乃
芡	芡
财	财
瀧	瀧
岿	岿
湍	湍
寞	寞
湝	湝
整	整
佐	佐
氾	氾
駒	駒
候	候
免	免
傣	傣
崐	崐
姥	姥
逗	逗
昙	昙
眺	眺
習	習
牛	牛
饑	饑
琍	琍
摁	摁
颤	颤
嘞	嘞
蘼	蘼
綦	綦
呛	呛
醅	醅
蹑	蹑
瘰	瘰
拳	拳
衩	衩
皿	皿
标	标
謁	謁
垫	垫
敲	敲
淞	淞
餃	餃
組	組
弗	弗
违	违
國	國
賢	賢
兮	兮
讯	讯
鸿	鸿
病	病
麥	麥
辨	辨
茆	茆
航	航
五	五
齒	齒
奉	奉
柜	柜
惶	惶
涝	涝
望	望
荤	荤
硌	硌
棱	棱
陕	陕
月	月
懦	懦
悦	悦
贺	贺
逓	逓
移	移
银	银
闲	闲
碌	碌
遷	遷
醺	醺
塗	塗
緩	緩
塌	塌
闺	闺
雫	雫
桄	桄
蜆	蜆
貉	貉
掂	掂
绢	绢
垍	垍
蜿	蜿
蚵	蚵
蒂	蒂
扮	扮
育	育
锨	锨
谶	谶
箓	箓
希	希
澡	澡
笞	笞
兑	兑
辭	辭
兵	兵
钕	钕
團	團
腌	腌
陟	陟
柤	柤
骷	骷
祥	祥
叫	叫
飢	飢
仏	仏
釘	釘
喉	喉
钺	钺
認	認
疴	疴
坑	坑
次	次
檸	檸
訕	訕
藝	藝
脣	脣
袓	袓
麴	麴
见	见
眼	眼
柘	柘
擬	擬
授	授
覚	覚
尕	尕
盼	盼
阅	阅
胯	胯
痞	痞
铅	铅
足	足
审	审
唑	唑
鎌	鎌
甸	甸
堍	堍
剖	剖
杯	杯
菌	菌
巛	巛
鍵	鍵
谴	谴
拟	拟
焼	焼
礫	礫
頜	頜
肪	肪
冢	冢
邀	邀
诬	诬
鹦	鹦
郇	郇
厘	厘
啫	啫
钭	钭
笃	笃
届	届
边	边
膽	膽
蹟	蹟
烀	烀
纱	纱
潭	潭
鹚	鹚
晴	晴
酶	酶
钝	钝
遵	遵
阁	阁
格	格
寅	寅
馇	馇
舷	舷
纏	纏
睢	睢
擁	擁
旯	旯
晩	晩
礎	礎
竽	竽
蒽	蒽
哮	哮
谰	谰
菟	菟
擎	擎
帯	帯
惪	惪
姑	姑
難	難
剛	剛
犸	犸
碍	碍
旰	旰
聯	聯
趾	趾
芋	芋
照	照
诱	诱
聋	聋
滨	滨
誉	誉
驼	驼
绑	绑
汁	汁
宦	宦
闇	闇
噜	噜
奎	奎
疽	疽
媽	媽
真	真
伫	伫
朝	朝
诅	诅
磅	磅
們	們
勻	勻
楼	楼
正	正
瓶	瓶
芊	芊
夯	夯
揷	揷
蹊	蹊
墓	墓
狼	狼
畊	畊
爵	爵
尓	尓
般	般
邨	邨
褛	褛
葷	葷
退	退
迭	迭
悼	悼
焊	焊
胭	胭
匙	匙
壹	壹
図	図
訛	訛
沇	沇
辩	辩
哆	哆
煊	煊
宵	宵
滦	滦
薁	薁
誅	誅
佥	佥
仄	仄
淖	淖
館	館
祈	祈
条	条
鹯	鹯
両	両
晤	晤
痢	痢
詡	詡
爾	爾
柿	柿
皖	皖
缪	缪
种	种
令	令
蓉	蓉
簦	簦
菀	菀
派	派
跺	跺
湾	湾
嫵	嫵
扳	扳
褒	褒
燧	燧
乓	乓
鼬	鼬
勐	勐
剀	剀
鲚	鲚
軟	軟
蒸	蒸
巯	巯
諺	諺
缫	缫
证	证
瘟	瘟
却	却
撚	撚
萌	萌
桀	桀
搜	搜
箕	箕
龇	龇
貴	貴
禎	禎
诐	诐
毛	毛
鬆	鬆
綸	綸
囧	囧
肥	肥
脖	脖
霸	霸
觇	觇
弐	弐
鈍	鈍
謾	謾
孛	孛
鲶	鲶
台	台
雌	雌
瀘	瀘
篤	篤
崤	崤
嚮	嚮
嬷	嬷
懶	懶
蒞	蒞
險	險
卓	卓
骕	骕
恁	恁
蠛	蠛
驗	驗
雨	雨
塡	塡
疚	疚
痈	痈
潩	潩
敦	敦
刳	刳
锎	锎
頃	頃
铵	铵
挠	挠
渦	渦
篪	篪
籴	籴
阴	阴
參	參
髪	髪
昝	昝
俐	俐
谣	谣
眷	眷
螢	螢
寤	寤
相	相
哪	哪
闊	闊
暮	暮
騙	騙
刷	刷
胺	胺
强	强
駅	駅
娱	娱
京	京
饮	饮
鸂	鸂
撸	撸
颏	颏
孵	孵
莳	莳
狠	狠
辘	辘
涸	涸
奴	奴
模	模
兀	兀
溼	溼
蹚	蹚
襠	襠
瑷	瑷
蓊	蓊
蜀	蜀
菊	菊
只	只
霎	霎
珠	珠
挡	挡
爐	爐
巍	巍
葱	葱
柄	柄
樉	樉
褚	褚
桃	桃
饱	饱
忄	忄
蛸	蛸
滄	滄
覓	覓
鶲	鶲
蘧	蘧
椅	椅
禄	禄
英	英
绐	绐
噴	噴
燒	燒
涚	涚
嶃	嶃
瑪	瑪
羡	羡
疇	疇
坐	坐
包	包
补	补
扒	扒
紧	紧
香	香
煥	煥
坵	坵
街	街
咀	咀
谡	谡
埕	埕
参	参
鞦	鞦
镓	镓
伯	伯
陡	陡
梯	梯
験	験
掀	掀
族	族
岡	岡
顶	顶
塔	塔
鈞	鈞
世	世
竚	竚
薹	薹
赂	赂
峨	峨
待	待
阆	阆
法	法
讃	讃
鳔	鳔
終	終
療	療
檩	檩
摅	摅
摈	摈
鋒	鋒
嬅	嬅
企	企
悬	悬
凌	凌
勰	勰
罅	罅
超	超
抓	抓
铊	铊
噻	噻
匪	匪
离	离
藐	藐
剩	剩
懒	懒
症	症
疵	疵
炷	炷
幟	幟
慥	慥
哟	哟
醚	醚
坊	坊
之	之
牡	牡
炕	炕
呕	呕
蝌	蝌
恸	恸
鳕	鳕
廊	廊
酩	酩
蒨	蒨
跋	跋
彎	彎
赉	赉
滢	滢
着	着
嵐	嵐
刃	刃
崮	崮
亥	亥
脈	脈
廓	廓
賺	賺
石	石
駭	駭
桠	桠
墮	墮
齋	齋
璆	璆
殉	殉
毡	毡
鲸	鲸
疾	疾
砗	砗
郏	郏
訪	訪
忻	忻
樑	樑
氰	氰
盘	盘
颉	颉
跹	跹
陽	陽
苡	苡
牆	牆
线	线
帕	帕
咪	咪
芙	芙
鄕	鄕
腻	腻
蕁	蕁
孀	孀
鶩	鶩
註	註
斗	斗
彩	彩
虜	虜
得	得
練	練
騕	騕
吿	吿
馕	馕
崆	崆
苛	苛
搓	搓
傘	傘
晨	晨
岚	岚
渥	渥
潔	潔
臧	臧
鳊	鳊
极	极
遛	遛
詮	詮
廣	廣
櫚	櫚
宕	宕
郄	郄
楫	楫
铪	铪
艮	艮
啉	啉
會	會
诜	诜
分	分
平	平
际	际
趸	趸
鉑	鉑
桌	桌
崗	崗
纻	纻
迈	迈
拂	拂
铟	铟
鳜	鳜
袭	袭
鄩	鄩
槭	槭
穷	穷
脁	脁
斃	斃
哇	哇
谀	谀
桕	桕
诹	诹
隰	隰
腊	腊
杪	杪
蘖	蘖
点	点
樵	樵
劁	劁
耽	耽
秧	秧
珮	珮
縈	縈
脛	脛
虑	虑
刨	刨
橇	橇
配	配
仲	仲
桂	桂
電	電
辉	辉
冬	冬
虫	虫
蜈	蜈
顔	顔
丝	丝
蚊	蚊
渌	渌
阇	阇
黄	黄
彊	彊
嗥	嗥
瓘	瓘
夕	夕
裊	裊
不	不
瓮	瓮
欄	欄
肓	肓
溺	溺
叹	叹
咽	咽
公	公
彳	彳
這	這
悝	悝
嗪	嗪
洐	洐
绩	绩
堡	堡
砭	砭
帝	帝
鷲	鷲
浥	浥
吁	吁
郧	郧
垛	垛
全	全
讫	讫
裸	裸
貓	貓
曜	曜
鼻	鼻
朱	朱
矚	矚
剤	剤
孕	孕
帔	帔
右	右
塊	塊
喬	喬
顗	顗
倒	倒
值	值
镑	镑
繩	繩
蒡	蒡
扈	扈
闡	闡
學	學
各	各
飛	飛
庞	庞
獾	獾
赌	赌
罐	罐
骂	骂
氪	氪
浊	浊
抟	抟
祉	祉
咍	咍
筛	筛
闵	闵
牲	牲
膺	膺
钡	钡
爸	爸
等	等
衫	衫
鰻	鰻
侧	侧
恩	恩
克	克
卖	卖
逼	逼
筚	筚
倡	倡
蠢	蠢
炳	炳
疳	疳
珉	珉
癸	癸
卯	卯
璹	璹
斑	斑
墾	墾
触	触
锲	锲
曳	曳
贼	贼
爺	爺
錠	錠
嗷	嗷
銭	銭
弥	弥
汾	汾
閟	閟
荨	荨
癲	癲
瀕	瀕
架	架
筍	筍
蝻	蝻
蓑	蓑
豳	豳
人	人
傩	傩
瑯	瑯
锆	锆
浈	浈
悖	悖
瑟	瑟
蹦	蹦
涉	涉
冗	冗
確	確
框	框
盐	盐
脾	脾
迩	迩
擂	擂
攝	攝
仙	仙
搏	搏
邃	邃
宗	宗
淼	淼
唰	唰
制	制
鹫	鹫
瓜	瓜
荆	荆
毯	毯
湧	湧
耗	耗
挣	挣
謊	謊
穑	穑
文	文
恪	恪
焖	焖
仟	仟
骨	骨
璃	璃
覷	覷
諒	諒
挽	挽
嶓	嶓
均	均
宝	宝
戲	戲
评	评
帑	帑
篡	篡
冻	冻
在	在
榮	榮
挞	挞
簟	簟
逻	逻
臬	臬
渀	渀
帥	帥
浴	浴
唧	唧
寿	寿
塬	塬
透	透
崖	崖
巔	巔
轎	轎
凜	凜
团	团
叱	叱
熨	熨
充	充
鹏	鹏
墡	墡
盹	盹
骎	骎
鼐	鼐
賜	賜
帅	帅
蔽	蔽
誥	誥
牂	牂
跖	跖
竜	竜
餉	餉
横	横
绻	绻
較	較
蝠	蝠
嗫	嗫
家	家
曠	曠
襁	襁
堯	堯
布	布
肼	肼
摛	摛
寓	寓
昶	昶
隠	隠
多	多
诤	诤
鍺	鍺
灿	灿
咿	咿
庴	庴
蹋	蹋
镁	镁
醣	醣
嬿	嬿
雀	雀
辖	辖
政	政
笤	笤
樫	樫
讞	讞
諭	諭
鑑	鑑
歉	歉
汞	汞
块	块
邦	邦
皈	皈
盜	盜
條	條
婷	婷
餞	餞
卞	卞
檢	檢
額	額
惹	惹
辑	辑
豇	豇
陈	陈
中	中
茼	茼
鲳	鲳
偕	偕
侑	侑
屁	屁
禦	禦
戶	戶
翠	翠
恚	恚
美	美
硼	硼
矅	矅
踊	踊
传	传
题	题
嬰	嬰
涙	涙
辆	辆
汽	汽
商	商
猢	猢
飮	飮
梏	梏
瓊	瓊
髏	髏
愆	愆
堑	堑
莺	莺
攙	攙
赦	赦
徼	徼
橼	橼
怦	怦
顾	顾
酣	酣
钳	钳
仞	仞
牕	牕
掌	掌
矬	矬
討	討
防	防
经	经
诟	诟
矜	矜
昇	昇
滁	滁
庑	庑
餘	餘
磲	磲
鈉	鈉
鋤	鋤
蓬	蓬
緻	緻
柏	柏
疡	疡
酺	酺
捉	捉
稹	稹
頴	頴
幹	幹
诣	诣
徒	徒
澈	澈
袍	袍
準	準
徬	徬
甕	甕
侈	侈
靼	靼
惲	惲
耐	耐
圭	圭
皲	皲
长	长
騏	騏
憋	憋
旭	旭
繁	繁
譬	譬
趺	趺
還	還
聿	聿
览	览
輔	輔
頤	頤
广	广
凛	凛
豝	豝
嗚	嗚
反	反
琌	琌
靓	靓
怼	怼
馐	馐
苔	苔
褭	褭
熔	熔
恆	恆
適	適
箨	箨
貌	貌
腾	腾
玶	玶
算	算
璞	璞
坒	坒
華	華
隱	隱
咦	咦
虱	虱
杵	杵
韵	韵
叉	叉
嘧	嘧
籍	籍
琲	琲
底	底
繽	繽
阡	阡
沾	沾
嵬	嵬
掺	掺
瑜	瑜
沤	沤
貰	貰
緝	緝
尺	尺
谂	谂
竲	竲
鬏	鬏
柯	柯
袪	袪
巧	巧
摆	摆
訇	訇
麟	麟
汴	汴
快	快
究	究
妞	妞
揍	揍
咐	咐
鉉	鉉
瑋	瑋
酇	酇
座	座
眇	眇
砩	砩
癞	癞
滚	滚
兌	兌
为	为
潦	潦
訣	訣
绽	绽
鲤	鲤
妹	妹
豷	豷
鸬	鸬
浸	浸
舉	舉
釗	釗
场	场
狩	狩
縝	縝
朽	朽
濺	濺
蠅	蠅
盥	盥
雉	雉
劂	劂
余	余
魷	魷
鲡	鲡
彌	彌
慝	慝
众	众
蟾	蟾
髑	髑
插	插
偃	偃
奚	奚
粑	粑
諗	諗
浬	浬
梾	梾
坂	坂
晰	晰
鹹	鹹
姓	姓
洺	洺
鲜	鲜
寀	寀
钜	钜
琼	琼
搢	搢
舐	舐
撵	撵
垿	垿
昺	昺
柔	柔
杠	杠
馆	馆
遂	遂
铳	铳
繼	繼
檳	檳
宿	宿
陪	陪
钓	钓
哕	哕
鯰	鯰
憍	憍
乌	乌
禫	禫
俸	俸
妘	妘
痫	痫
偬	偬
叢	叢
挚	挚
鲁	鲁
恶	恶
赊	赊
礙	礙
散	散
渣	渣
矫	矫
經	經
笺	笺
惴	惴
锯	锯
亨	亨
鸵	鸵
哏	哏
村	村
饼	饼
諷	諷
肚	肚
铠	铠
鴉	鴉
吮	吮
瀑	瀑
嚥	嚥
窆	窆
镞	镞
僖	僖
融	融
揮	揮
燦	燦
壸	壸
遽	遽
涞	涞
珊	珊
涖	涖
蚶	蚶
悴	悴
惮	惮
漩	漩
锵	锵
素	素
炎	炎
胼	胼
原	原
贴	贴
狡	狡
嫡	嫡
缮	缮
暱	暱
摯	摯
蟎	蟎
癍	癍
郛	郛
殺	殺
絺	絺
泗	泗
荞	荞
咫	咫
喏	喏
剃	剃
檗	檗
喫	喫
評	評
华	华
敞	敞
瑁	瑁
鹬	鹬
侷	侷
翙	翙
權	權
钰	钰
薰	薰
胧	胧
谩	谩
媒	媒
銬	銬
熬	熬
襯	襯
郤	郤
随	随
鹣	鹣
恵	恵
餛	餛
鱿	鱿
王	王
篮	篮
爍	爍
骅	骅
莓	莓
徘	徘
船	船
觅	觅
赎	赎
僆	僆
賂	賂
哄	哄
嫖	嫖
汊	汊
消	消
端	端
覬	覬
丈	丈
楠	楠
広	広
巢	巢
炆	炆
匿	匿
劇	劇
洣	洣
桥	桥
肫	肫
重	重
慳	慳
酬	酬
壕	壕
窣	窣
蟆	蟆
柽	柽
廃	廃
旄	旄
啪	啪
瀉	瀉
隋	隋
唵	唵
荜	荜
蹶	蹶
歡	歡
鏟	鏟
坡	坡
弊	弊
陔	陔
雩	雩
絳	絳
央	央
嘭	嘭
师	师
测	测
吨	吨
標	標
唬	唬
澜	澜
擡	擡
畋	畋
屿	屿
哼	哼
痪	痪
橐	橐
券	券
与	与
屑	屑
射	射
材	材
蚁	蚁
襪	襪
倆	倆
蚧	蚧
鰲	鰲
柚	柚
槊	槊
骟	骟
亩	亩
檫	檫
谗	谗
疱	疱
靺	靺
笕	笕
曬	曬
喆	喆
劭	劭
羽	羽
缟	缟
姨	姨
翡	翡
贓	贓
蛛	蛛
轅	轅
蓄	蓄
须	须
爷	爷
友	友
剪	剪
粘	粘
青	青
倦	倦
謐	謐
奇	奇
炒	炒
贿	贿
贽	贽
髯	髯
燄	燄
挈	挈
珩	珩
蝕	蝕
糾	糾
刪	刪
念	念
黯	黯
蛊	蛊
骯	骯
扑	扑
墙	墙
窠	窠
蠹	蠹
夸	夸
喂	喂
唳	唳
萦	萦
二	二
虚	虚
绉	绉
发	发
漲	漲
抠	抠
試	試
蚩	蚩
貧	貧
缘	缘
晷	晷
哲	哲
義	義
颍	颍
賊	賊
侠	侠
備	備
釉	釉
獨	獨
蠱	蠱
咹	咹
憧	憧
玮	玮
冔	冔
幂	幂
圍	圍
鳅	鳅
波	波
鼱	鼱
远	远
垤	垤
揭	揭
涩	涩
合	合
凭	凭
網	網
琏	琏
番	番
灼	灼
谐	谐
蚴	蚴
屉	屉
返	返
梳	梳
玷	玷
綾	綾
湉	湉
井	井
扼	扼
昱	昱
朴	朴
务	务
茏	茏
茨	茨
莅	莅
颚	颚
扥	扥
蘑	蘑
梟	梟
珅	珅
御	御
疠	疠
腼	腼
鼠	鼠
兒	兒
爱	爱
筹	筹
岙	岙
侖	侖
煸	煸
澆	澆
吋	吋
顽	顽
呤	呤
濑	濑
浪	浪
繳	繳
廈	廈
綖	綖
落	落
錶	錶
徐	徐
檯	檯
虏	虏
钿	钿
孱	孱
鏐	鏐
恰	恰
侶	侶
譲	譲
泾	泾
轩	轩
奭	奭
囱	囱
莠	莠
瞰	瞰
聃	聃
鲋	鲋
渑	渑
覩	覩
祋	祋
绛	绛
駃	駃
敗	敗
變	變
郅	郅
賑	賑
頒	頒
奬	奬
亭	亭
樗	樗
缢	缢
纾	纾
婭	婭
複	複
窜	窜
峥	峥
傭	傭
胳	胳
妊	妊
摻	摻
幅	幅
称	称
頑	頑
汎	汎
劊	劊
觯	觯
清	清
囚	囚
褲	褲
酿	酿
惬	惬
誦	誦
抿	抿
佬	佬
實	實
裡	裡
瓯	瓯
唷	唷
吧	吧
冤	冤
荐	荐
堺	堺
繭	繭
弧	弧
早	早
澹	澹
驒	驒
镠	镠
専	専
壇	壇
吓	吓
剷	剷
擰	擰
啶	啶
踱	踱
先	先
耆	耆
挺	挺
砚	砚
帧	帧
渚	渚
羣	羣
幺	幺
戏	戏
祯	祯
载	载
孢	孢
蒐	蒐
钧	钧
镰	镰
菓	菓
蘭	蘭
埙	埙
玢	玢
翳	翳
悩	悩
诓	诓
斂	斂
楨	楨
瘤	瘤
课	课
獅	獅
痙	痙
完	完
结	结
憬	憬
蹩	蹩
瘠	瘠
撒	撒
壯	壯
歙	歙
計	計
搡	搡
鋁	鋁
羯	羯
獄	獄
循	循
辏	辏
鼋	鼋
霄	霄
柬	柬
掇	掇
荠	荠
嗬	嗬
扉	扉
濘	濘
杀	杀
滴	滴
属	属
蝥	蝥
塍	塍
鳎	鳎
悚	悚
騁	騁
影	影
瞅	瞅
廖	廖
憀	憀
噸	噸
搖	搖
摊	摊
穫	穫
驚	驚
拊	拊
筝	筝
歛	歛
募	募
跆	跆
蝨	蝨
鞑	鞑
茑	茑
苫	苫
灶	灶
袗	袗
洪	洪
纍	纍
俭	俭
慨	慨
嵊	嵊
墊	墊
隗	隗
赠	赠
戟	戟
晏	晏
嶂	嶂
鸦	鸦
莘	莘
皙	皙
窗	窗
拼	拼
遺	遺
阏	阏
鳩	鳩
單	單
像	像
憐	憐
骢	骢
忐	忐
闹	闹
根	根
辊	辊
徇	徇
较	较
闍	闍
逍	逍
偻	偻
擊	擊
滑	滑
谜	谜
要	要
缶	缶
渉	渉
昧	昧
絢	絢
懲	懲
鸻	鸻
鸞	鸞
銮	銮
敏	敏
袱	袱
咙	咙
毐	毐
助	助
樓	樓
嚼	嚼
汛	汛
慌	慌
妝	妝
決	決
锚	锚
竅	竅
彬	彬
謠	謠
週	週
惋	惋
茭	茭
嬤	嬤
疸	疸
桉	桉
墩	墩
纡	纡
样	样
辔	辔
海	海
叭	叭
垅	垅
酐	酐
崦	崦
垭	垭
躯	躯
贅	贅
滷	滷
尷	尷
嘿	嘿
崴	崴
滌	滌
缤	缤
烤	烤
愈	愈
泚	泚
審	審
肯	肯
虛	虛
螭	螭
吻	吻
殯	殯
鴿	鴿
集	集
災	災
尘	尘
断	断
湃	湃
辎	辎
亘	亘
數	數
醪	醪
某	某
箸	箸
痂	痂
孬	孬
歲	歲
傺	傺
噬	噬
祆	祆
騠	騠
吝	吝
巅	巅
搵	搵
珙	珙
裾	裾
豉	豉
鹜	鹜
楯	楯
澱	澱
踢	踢
隶	隶
蝽	蝽
趄	趄
蔸	蔸
蜒	蜒
躺	躺
鄔	鄔
孰	孰
燭	燭
闸	闸
諡	諡
罗	罗
礪	礪
赝	赝
捎	捎
璁	璁
困	困
忡	忡
娣	娣
贰	贰
息	息
稍	稍
哚	哚
鞏	鞏
醋	醋
币	币
溢	溢
恨	恨
嚎	嚎
泓	泓
蹺	蹺
鋼	鋼
呼	呼
鸳	鸳
鈔	鈔
悕	悕
株	株
祂	祂
话	话
禨	禨
謨	謨
潘	潘
魍	魍
橄	橄
膠	膠
沁	沁
涅	涅
糟	糟
赛	赛
锅	锅
铀	铀
侬	侬
吉	吉
軋	軋
嗲	嗲
缥	缥
楞	楞
咂	咂
凼	凼
昨	昨
堅	堅
潴	潴
圣	圣
桑	桑
薊	薊
裹	裹
罹	罹
葬	葬
輕	輕
冕	冕
拋	拋
攬	攬
彪	彪
醇	醇
延	延
袅	袅
講	講
壑	壑
估	估
詠	詠
藥	藥
憑	憑
鄫	鄫
霏	霏
拷	拷
帖	帖
甄	甄
儆	儆
獎	獎
蕨	蕨
糊	糊
喑	喑
啡	啡
聂	聂
潋	潋
棹	棹
封	封
瓿	瓿
垵	垵
腿	腿
彫	彫
意	意
悫	悫
箔	箔
吠	吠
普	普
件	件
篇	篇
匕	匕
閏	閏
灝	灝
淑	淑
犄	犄
嚇	嚇
緊	緊
磚	磚
歓	歓
癇	癇
廿	廿
晔	晔
雾	雾
睚	睚
阿	阿
鲢	鲢
琠	琠
頫	頫
嚕	嚕
澤	澤
嚅	嚅
鴐	鴐
骰	骰
娵	娵
裢	裢
郜	郜
层	层
袈	袈
猕	猕
斋	斋
邝	邝
棒	棒
惊	惊
靂	靂
阖	阖
揃	揃
新	新
巡	巡
妮	妮
淩	淩
喰	喰
鐳	鐳
偉	偉
織	織
谢	谢
話	話
姫	姫
氓	氓
藹	藹
嘱	嘱
鹅	鹅
睏	睏
首	首
腋	腋
車	車
镂	镂
怄	怄
遗	遗
讥	讥
刺	刺
進	進
常	常
噪	噪
荫	荫
釋	釋
墎	墎
幛	幛
谷	谷
鹇	鹇
芮	芮
睜	睜
飪	飪
奏	奏
汝	汝
箇	箇
棄	棄
粮	粮
妍	妍
旨	旨
觚	觚
氩	氩
羚	羚
攀	攀
淡	淡
铮	铮
聖	聖
汆	汆
菪	菪
钾	钾
雍	雍
侣	侣
枷	枷
泔	泔
廉	廉
来	来
泽	泽
翥	翥
茱	茱
孳	孳
堃	堃
县	县
種	種
鰾	鰾
挥	挥
巫	巫
找	找
痘	痘
藉	藉
搔	搔
蚬	蚬
獐	獐
检	检
滾	滾
納	納
羟	羟
戢	戢
帘	帘
跣	跣
垌	垌
们	们
颇	颇
兼	兼
瀅	瀅
莿	莿
织	织
贖	贖
斷	斷
儋	儋
媾	媾
饔	饔
侍	侍
崎	崎
喻	喻
賓	賓
洋	洋
諸	諸
忝	忝
护	护
金	金
圻	圻
达	达
脉	脉
蟋	蟋
喔	喔
霜	霜
绝	绝
蠔	蠔
吕	吕
鲨	鲨
築	築
业	业
芳	芳
逑	逑
禾	禾
物	物
陶	陶
懊	懊
佣	佣
嬲	嬲
堨	堨
鄜	鄜
瘪	瘪
壅	壅
程	程
撬	撬
眛	眛
儲	儲
対	対
仍	仍
槌	槌
麂	麂
阂	阂
滞	滞
荻	荻
茄	茄
当	当
桦	桦
懺	懺
鹤	鹤
枇	枇
扞	扞
硅	硅
啼	啼
瓠	瓠
龄	龄
胸	胸
厨	厨
桅	桅
版	版
駄	駄
虺	虺
惕	惕
鋅	鋅
榉	榉
墅	墅
畫	畫
欖	欖
谔	谔
贪	贪
綽	綽
巻	巻
伍	伍
迅	迅
逝	逝
邠	邠
梦	梦
榜	榜
瘀	瘀
磐	磐
晒	晒
洛	洛
懇	懇
箝	箝
旺	旺
钢	钢
晟	晟
旋	旋
膈	膈
瘥	瘥
伺	伺
耕	耕
萤	萤
蠳	蠳
碇	碇
将	将
愍	愍
睿	睿
箩	箩
棺	棺
睬	睬
这	这
悅	悅
艱	艱
钏	钏
虧	虧
彷	彷
跬	跬
喭	喭
价	价
州	州
咸	咸
眩	眩
覧	覧
騷	騷
沂	沂
羿	羿
唉	唉
颎	颎
綫	綫
髌	髌
議	議
牟	牟
觞	觞
芩	芩
队	队
贫	贫
糗	糗
努	努
铃	铃
犀	犀
赤	赤
狰	狰
勘	勘
颊	颊
羈	羈
察	察
韻	韻
挟	挟
锌	锌
礻	礻
讀	讀
瀾	瀾
捣	捣
疮	疮
闖	闖
摀	摀
袒	袒
认	认
镭	镭
設	設
栢	栢
泳	泳
告	告
孖	孖
奫	奫
姦	姦
迷	迷
趁	趁
寰	寰
矣	矣
捷	捷
洼	洼
毂	毂
芻	芻
零	零
呆	呆
古	古
創	創
篩	篩
露	露
財	財
僕	僕
囲	囲
缙	缙
羰	羰
漿	漿
偎	偎
猁	猁
赵	赵
路	路
停	停
咣	咣
茴	茴
求	求
畑	畑
醃	醃
売	売
軍	軍
艉	艉
揺	揺
浇	浇
將	將
辅	辅
渎	渎
丐	丐
悠	悠
替	替
曷	曷
垕	垕
湮	湮
質	質
蘇	蘇
驕	驕
邱	邱
訳	訳
擦	擦
湖	湖
锡	锡
戈	戈
溏	溏
暕	暕
柑	柑
薈	薈
窈	窈
栉	栉
寂	寂
麹	麹
蝼	蝼
豈	豈
団	団
僱	僱
紂	紂
螃	螃
贬	贬
镍	镍
喪	喪
罕	罕
淵	淵
客	客
辍	辍
萱	萱
皺	皺
驅	驅
嬢	嬢
厙	厙
炔	炔
鄯	鄯
概	概
饶	饶
黡	黡
攞	攞
踉	踉
嬴	嬴
跱	跱
淆	淆
犇	犇
鳶	鳶
庆	庆
椿	椿
嚨	嚨
鈀	鈀
迂	迂
绔	绔
丶	丶
褴	褴
鵬	鵬
苎	苎
葉	葉
深	深
紳	紳
羸	羸
絜	絜
牽	牽
鸭	鸭
杭	杭
絃	絃
畢	畢
刹	刹
拄	拄
牾	牾
蜱	蜱
袂	袂
乐	乐
胰	胰
滔	滔
虿	虿
嘻	嘻
獰	獰
長	長
纬	纬
宣	宣
棟	棟
鯖	鯖
壮	壮
麇	麇
论	论
贛	贛
実	実
镕	镕
趿	趿
镀	镀
壆	壆
邊	邊
掖	掖
贻	贻
蘆	蘆
竦	竦
譏	譏
扶	扶
洌	洌
餐	餐
芬	芬
挾	挾
灭	灭
琎	琎
箱	箱
胗	胗
跤	跤
项	项
瞽	瞽
臂	臂
敎	敎
揪	揪
挂	挂
戻	戻
佩	佩
唢	唢
蝟	蝟
淬	淬
穴	穴
避	避
脳	脳
蕾	蕾
奧	奧
累	累
咝	咝
茂	茂
己	己
瓏	瓏
笑	笑
堇	堇
猛	猛
関	関
顫	顫
裕	裕
鸷	鸷
栓	栓
棣	棣
谄	谄
忍	忍
危	危
恽	恽
辱	辱
榖	榖
慧	慧
徽	徽
匱	匱
油	油
侨	侨
蝾	蝾
烁	烁
覺	覺
瘳	瘳
撰	撰
矱	矱
働	働
芦	芦
治	治
私	私
坟	坟
橡	橡
供	供
耻	耻
錢	錢
邑	邑
琴	琴
臓	臓
缺	缺
貯	貯
玑	玑
隕	隕
刈	刈
璠	璠
枹	枹
菡	菡
枧	枧
莸	莸
烧	烧
謔	謔
睫	睫
瘘	瘘
洽	洽
儂	儂
擢	擢
鰓	鰓
濮	濮
嚓	嚓
盃	盃
鈣	鈣
喃	喃
聡	聡
忾	忾
沛	沛
洒	洒
圪	圪
篙	篙
君	君
玥	玥
膚	膚
峤	峤
貸	貸
伎	伎
遭	遭
珽	珽
勣	勣
鐵	鐵
解	解
位	位
压	压
绌	绌
嘖	嘖
饌	饌
民	民
莴	莴
诈	诈
協	協
颔	颔
稲	稲
优	优
麝	麝
隣	隣
邺	邺
孪	孪
乙	乙
屬	屬
坛	坛
俯	俯
操	操
荳	荳
誹	誹
麦	麦
陝	陝
碴	碴
奕	奕
啄	啄
厭	厭
哌	哌
諲	諲
讼	讼
鷏	鷏
寫	寫
惟	惟
嫚	嫚
坯	坯
猗	猗
弋	弋
栄	栄
漷	漷
差	差
衡	衡
闷	闷
篁	篁
麺	麺
精	精
彥	彥
浉	浉
殛	殛
鸢	鸢
寶	寶
仇	仇
欧	欧
記	記
筆	筆
牢	牢
镫	镫
癢	癢
線	線
續	續
穹	穹
炁	炁
郸	郸
贍	贍
淋	淋
颧	颧
茁	茁
衬	衬
富	富
悟	悟
匦	匦
天	天
酰	酰
儉	儉
共	共
愿	愿
略	略
絹	絹
并	并
偽	偽
药	药
菠	菠
礡	礡
梢	梢
妖	妖
暦	暦
兔	兔
琚	琚
龙	龙
朦	朦
邪	邪
咱	咱
谆	谆
纖	纖
訴	訴
痿	痿
噹	噹
墀	墀
阑	阑
廚	廚
誘	誘
浯	浯
薦	薦
蟀	蟀
堵	堵
頰	頰
距	距
哦	哦
斡	斡
鄂	鄂
毽	毽
楢	楢
议	议
谚	谚
动	动
蹰	蹰
篚	篚
赖	赖
迟	迟
馋	馋
软	软
氤	氤
置	置
讪	讪
磋	磋
胄	胄
绣	绣
倌	倌
蔗	蔗
捱	捱
獲	獲
报	报
忿	忿
劾	劾
批	批
蓋	蓋
岂	岂
敍	敍
爽	爽
趋	趋
吃	吃
撞	撞
推	推
骚	骚
特	特
鳏	鳏
保	保
鎊	鎊
懵	懵
阽	阽
岩	岩
仮	仮
敘	敘
贏	贏
肢	肢
捡	捡
穿	穿
误	误
杖	杖
峁	峁
膩	膩
缦	缦
細	細
薔	薔
积	积
回	回
矇	矇
跃	跃
燥	燥
邗	邗
衄	衄
缅	缅
米	米
灑	灑
臥	臥
須	須
岣	岣
凃	凃
觐	觐
寨	寨
佞	佞
的	的
面	面
谕	谕
灸	灸
冷	冷
轮	轮
隍	隍
濤	濤
居	居
煜	煜
吭	吭
谑	谑
刮	刮
妇	妇
肿	肿
衔	衔
訂	訂
睛	睛
析	析
箬	箬
莫	莫
債	債
崇	崇
枢	枢
雄	雄
填	填
脆	脆
饞	饞
屋	屋
铯	铯
疤	疤
氙	氙
鈎	鈎
颅	颅
楚	楚
楣	楣
兽	兽
枣	枣
殃	殃
局	局
蛻	蛻
讣	讣
饕	饕
丑	丑
媛	媛
槤	槤
鎏	鎏
靖	靖
埋	埋
频	频
诞	诞
纮	纮
每	每
貕	貕
鸟	鸟
闭	闭
斩	斩
姜	姜
欸	欸
问	问
纶	纶
语	语
搐	搐
碉	碉
楔	楔
殆	殆
涧	涧
妱	妱
栾	栾
锳	锳
菇	菇
眾	眾
碘	碘
瀛	瀛
龌	龌
摩	摩
鳙	鳙
帮	帮
鄅	鄅
媪	媪
弱	弱
溥	溥
崧	崧
境	境
奶	奶
攒	攒
键	键
譙	譙
铎	铎
伝	伝
墨	墨
吊	吊
棧	棧
襲	襲
韆	韆
岗	岗
恳	恳
能	能
慘	慘
鞆	鞆
籟	籟
詧	詧
瞳	瞳
岌	岌
廪	廪
幫	幫
祗	祗
赭	赭
娇	娇
沿	沿
卧	卧
簧	簧
涛	涛
雙	雙
擠	擠
耨	耨
凖	凖
翚	翚
坜	坜
滇	滇
觜	觜
唇	唇
亵	亵
低	低
捲	捲
茛	茛
囫	囫
滟	滟
猾	猾
沔	沔
鹂	鹂
糜	糜
籃	籃
钫	钫
伢	伢
齦	齦
淒	淒
轶	轶
讲	讲
嚷	嚷
蛐	蛐
馑	馑
费	费
攢	攢
野	野
颓	颓
疰	疰
纓	纓
庄	庄
擱	擱
願	願
択	択
床	床
嚐	嚐
秆	秆
票	票
柃	柃
荘	荘
服	服
欣	欣
紡	紡
荃	荃
換	換
妓	妓
弾	弾
睾	睾
色	色
籐	籐
閻	閻
丨	丨
冶	冶
铋	铋
峡	峡
凸	凸
豨	豨
聚	聚
韬	韬
善	善
畯	畯
歧	歧
橘	橘
笏	笏
烊	烊
謎	謎
遠	遠
稔	稔
那	那
潑	潑
贵	贵
禍	禍
豐	豐
挑	挑
蟑	蟑
谥	谥
鲌	鲌
季	季
颡	颡
役	役
菸	菸
谙	谙
雛	雛
訊	訊
怙	怙
漼	漼
宅	宅
錫	錫
屜	屜
蹤	蹤
殭	殭
导	导
焜	焜
詢	詢
岛	岛
绞	绞
瞩	瞩
綬	綬
剔	剔
瑮	瑮
驸	驸
剌	剌
详	详
隨	隨
式	式
掣	掣
镜	镜
祇	祇
陛	陛
谅	谅
錄	錄
盩	盩
逃	逃
瑚	瑚
南	南
偵	偵
孤	孤
颞	颞
喧	喧
舵	舵
儡	儡
禅	禅
疋	疋
乒	乒
祁	祁
煎	煎
鏊	鏊
遨	遨
紫	紫
俄	俄
襦	襦
鄙	鄙
儷	儷
它	它
闩	闩
宥	宥
揹	揹
六	六
量	量
蝸	蝸
髗	髗
事	事
莲	莲
咖	咖
鄋	鄋
颁	颁
勖	勖
镋	镋
驻	驻
啰	啰
廢	廢
铍	铍
辂	辂
骝	骝
衾	衾
匄	匄
尼	尼
幡	幡
東	東
卤	卤
郢	郢
锭	锭
嗆	嗆
徜	徜
肣	肣
獗	獗
靑	靑
稠	稠
駕	駕
丕	丕
鹰	鹰
硖	硖
烔	烔
显	显
疆	疆
傅	傅
爆	爆
膏	膏
墒	墒
錨	錨
鐺	鐺
嫩	嫩
晳	晳
優	優
荟	荟
痉	痉
哭	哭
刑	刑
协	协
颼	颼
宾	宾
醞	醞
煒	煒
詼	詼
契	契
琳	琳
捨	捨
罚	罚
十	十
页	页
咔	咔
絆	絆
骊	骊
弩	弩
豁	豁
矶	矶
鎮	鎮
日	日
総	総
閾	閾
申	申
涯	涯
兹	兹
骧	骧
磔	磔
蕗	蕗
岖	岖
铚	铚
土	土
鶒	鶒
核	核
例	例
诿	诿
嫌	嫌
囊	囊
曖	曖
砟	砟
旧	旧
轭	轭
責	責
漫	漫
祜	祜
娄	娄
癱	癱
俞	俞
風	風
臭	臭
畏	畏
树	树
注	注
向	向
撇	撇
曇	曇
仁	仁
谏	谏
徵	徵
燈	燈
蘡	蘡
邅	邅
陸	陸
萼	萼
賽	賽
绳	绳
僚	僚
堀	堀
店	店
前	前
啬	啬
書	書
权	权
猇	猇
楝	楝
嗦	嗦
桁	桁
仨	仨
阼	阼
犒	犒
掰	掰
聊	聊
鷗	鷗
戬	戬
邈	邈
觉	觉
炼	炼
嫱	嫱
菏	菏
葯	葯
猜	猜
阃	阃
贞	贞
邁	邁
嫲	嫲
瑰	瑰
做	做
库	库
嗖	嗖
劳	劳
児	児
细	细
起	起
裁	裁
脲	脲
陬	陬
栲	栲
白	白
坪	坪
塘	塘
盤	盤
闫	闫
液	液
曹	曹
玠	玠
嘸	嘸
熠	熠
町	町
耿	耿
暖	暖
芫	芫
唸	唸
馳	馳
开	开
軽	軽
竇	竇
膛	膛
舗	舗
醜	醜
甘	甘
職	職
嶷	嶷
晃	晃
噱	噱
擘	擘
鬟	鬟
刼	刼
醐	醐
轧	轧
愎	愎
蕩	蕩
動	動
鬍	鬍
妤	妤
胤	胤
搧	搧
颳	颳
璜	璜
棘	棘
纁	纁
岱	岱
懑	懑
绅	绅
雕	雕
豊	豊
嘎	嘎
辛	辛
颖	颖
嫉	嫉
缄	缄
绚	绚
愧	愧
驯	驯
愷	愷
陰	陰
閔	閔
婕	婕
径	径
嚲	嚲
邾	邾
斎	斎
械	械
顿	顿
苦	苦
浄	浄
啤	啤
谎	谎
卷	卷
訖	訖
卢	卢
廂	廂
猩	猩
狀	狀
泆	泆
辟	辟
书	书
幼	幼
码	码
涼	涼
嘶	嘶
喚	喚
禹	禹
枞	枞
攻	攻
題	題
罂	罂
凰	凰
仗	仗
主	主
诵	诵
炽	炽
母	母
圉	圉
磨	磨
隧	隧
閱	閱
幀	幀
驹	驹
埗	埗
閩	閩
貿	貿
侔	侔
茉	茉
董	董
旌	旌
耸	耸
銹	銹
泫	泫
癣	癣
窭	窭
切	切
瀏	瀏
嵛	嵛
厮	厮
嗇	嗇
理	理
呸	呸
铉	铉
啐	啐
憲	憲
泐	泐
訚	訚
草	草
救	救
臻	臻
溧	溧
鬲	鬲
剿	剿
哽	哽
發	發
粕	粕
于	于
針	針
喾	喾
缇	缇
簇	簇
曝	曝
噁	噁
熹	熹
涑	涑
唐	唐
抉	抉
扩	扩
楹	楹
黛	黛
钨	钨
舱	舱
埃	埃
蛙	蛙
腓	腓
慰	慰
绺	绺
羔	羔
貼	貼
呲	呲
摽	摽
臆	臆
掉	掉
孺	孺
撅	撅
衢	衢
福	福
徑	徑
绨	绨
考	考
貪	貪
铭	铭
徠	徠
腭	腭
筋	筋
糕	糕
槲	槲
套	套
丫	丫
甬	甬
悉	悉
嫂	嫂
仓	仓
用	用
衛	衛
駝	駝
糞	糞
伥	伥
霹	霹
蚀	蚀
氹	氹
芎	芎
爝	爝
到	到
鬻	鬻
環	環
啦	啦
婿	婿
醲	醲
別	別
镣	镣
側	側
臨	臨
臺	臺
失	失
瑠	瑠
脇	脇
趔	趔
婵	婵
揣	揣
尴	尴
絡	絡
焮	焮
機	機
媳	媳
蜛	蜛
澚	澚
酷	酷
暨	暨
枭	枭
襞	襞
取	取
汐	汐
逆	逆
谧	谧
踟	踟
褓	褓
訓	訓
釜	釜
颌	颌
漓	漓
輛	輛
单	单
沃	沃
乡	乡
鲷	鲷
碚	碚
漭	漭
馁	馁
嫁	嫁
诘	诘
腮	腮
齿	齿
貞	貞
槟	槟
苞	苞
义	义
锫	锫
抚	抚
执	执
鲹	鲹
债	债
冪	冪
鳥	鳥
狝	狝
黟	黟
屺	屺
厄	厄
吼	吼
灯	灯
牠	牠
嘢	嘢
籠	籠
睹	睹
挖	挖
疃	疃
网	网
琰	琰
瑛	瑛
壞	壞
煮	煮
抽	抽
芷	芷
吩	吩
尹	尹
裬	裬
濬	濬
穸	穸
諮	諮
盲	盲
繪	繪
鈴	鈴
被	被
崙	崙
樊	樊
穩	穩
瘧	瘧
跪	跪
芘	芘
蝶	蝶
晉	晉
粧	粧
斟	斟
酊	酊
瑕	瑕
扇	扇
类	类
捆	捆
餾	餾
晌	晌
甩	甩
詔	詔
暗	暗
雎	雎
獠	獠
椽	椽
弛	弛
忠	忠
披	披
产	产
畚	畚
掙	掙
源	源
葫	葫
肋	肋
患	患
钗	钗
傕	傕
髡	髡
裟	裟
菉	菉
诛	诛
翅	翅
钯	钯
控	控
僅	僅
倖	倖
郊	郊
态	态
縻	縻
兆	兆
焐	焐
怀	怀
桤	桤
蔬	蔬
燜	燜
勃	勃
胚	胚
搽	搽
瑩	瑩
鬓	鬓
暴	暴
眉	眉
账	账
槩	槩
个	个
槳	槳
籀	籀
或	或
宪	宪
牙	牙
泸	泸
鈺	鈺
壽	壽
骹	骹
鼹	鼹
腑	腑
褫	褫
階	階
茸	茸
蝙	蝙
轄	轄
呢	呢
惜	惜
旃	旃
炬	炬
芹	芹
恺	恺
猴	猴
滸	滸
饥	饥
嚯	嚯
膳	膳
呗	呗
歐	歐
噙	噙
萸	萸
邻	邻
磯	磯
梆	梆
撲	撲
誓	誓
疗	疗
纣	纣
陵	陵
稱	稱
谖	谖
竿	竿
嘹	嘹
醵	醵
構	構
趙	趙
嗟	嗟
轼	轼
璋	璋
積	積
坼	坼
伷	伷
售	售
逐	逐
夢	夢
莎	莎
弘	弘
峒	峒
眶	眶
笙	笙
倧	倧
瀍	瀍
碜	碜
芥	芥
昕	昕
潧	潧
璿	璿
瘓	瘓
聩	聩
腩	腩
譎	譎
倢	倢
绡	绡
毁	毁
雰	雰
厅	厅
父	父
涤	涤
烬	烬
宽	宽
負	負
頭	頭
熳	熳
愉	愉
诂	诂
内	内
室	室
匣	匣
腎	腎
襃	襃
赔	赔
囑	囑
涘	涘
佺	佺
検	検
睡	睡
釦	釦
丸	丸
故	故
荖	荖
粵	粵
观	观
堕	堕
湘	湘
腳	腳
迴	迴
施	施
窃	窃
鉛	鉛
纽	纽
鏞	鏞
喀	喀
嶋	嶋
秽	秽
緑	緑
变	变
範	範
里	里
挪	挪
悛	悛
殓	殓
否	否
黢	黢
澳	澳
拾	拾
铌	铌
罵	罵
铜	铜
絕	絕
鞥	鞥
婶	婶
褪	褪
澗	澗
脹	脹
庖	庖
獼	獼
梧	梧
橫	橫
齐	齐
搪	搪
姹	姹
済	済
叡	叡
盂	盂
濂	濂
壬	壬
侦	侦
神	神
遅	遅
鼩	鼩
铢	铢
尊	尊
捏	捏
虓	虓
帰	帰
官	官
鏽	鏽
蔔	蔔
溜	溜
区	区
咩	咩
烏	烏
畿	畿
詳	詳
齑	齑
姿	姿
憾	憾
禁	禁
態	態
媧	媧
膀	膀
蕃	蕃
恣	恣
亍	亍
錯	錯
悄	悄
迎	迎
揉	揉
鲫	鲫
悲	悲
识	识
讶	讶
半	半
濠	濠
乔	乔
穆	穆
啞	啞
鵝	鵝
吴	吴
撫	撫
貔	貔
蔘	蔘
矿	矿
祐	祐
髒	髒
鲽	鲽
孽	孽
军	军
垃	垃
栊	栊
隴	隴
创	创
蓁	蓁
庋	庋
璩	璩
遏	遏
郗	郗
坤	坤
笆	笆
赏	赏
敢	敢
雅	雅
峪	峪
囍	囍
伶	伶
再	再
资	资
鄒	鄒
囡	囡
景	景
鼙	鼙
鯊	鯊
鞨	鞨
丽	丽
剉	剉
帻	帻
姻	姻
碧	碧
唔	唔
焦	焦
祎	祎
寛	寛
捧	捧
蜕	蜕
豎	豎
及	及
筭	筭
箏	箏
梭	梭
召	召
稳	稳
預	預
酡	酡
盛	盛
俎	俎
榄	榄
嵯	嵯
栗	栗
瀞	瀞
烜	烜
具	具
紑	紑
嶇	嶇
啕	啕
晞	晞
杓	杓
蛤	蛤
轻	轻
蘚	蘚
泪	泪
蔡	蔡
憶	憶
硪	硪
哝	哝
琛	琛
詞	詞
沐	沐
簿	簿
度	度
呖	呖
笼	笼
泰	泰
拆	拆
曆	曆
顱	顱
嵝	嵝
初	初
绾	绾
荁	荁
濾	濾
規	規
噎	噎
躪	躪
苁	苁
雏	雏
袞	袞
樹	樹
羧	羧
倘	倘
登	登
碎	碎
紉	紉
褦	褦
蒟	蒟
娴	娴
哂	哂
阌	阌
诚	诚
酥	酥
煨	煨
仔	仔
穣	穣
搶	搶
觀	觀
產	產
韜	韜
龐	龐
柳	柳
勍	勍
踴	踴
蒲	蒲
黧	黧
鑫	鑫
酒	酒
腆	腆
詭	詭
枋	枋
龅	龅
坏	坏
渋	渋
楸	楸
鄉	鄉
赢	赢
阐	阐
亮	亮
驷	驷
赫	赫
鹊	鹊
匠	匠
呷	呷
鲇	鲇
蠍	蠍
詆	詆
森	森
涇	涇
龜	龜
焗	焗
缛	缛
傾	傾
夜	夜
警	警
論	論
凑	凑
紺	紺
四	四
讵	讵
滏	滏
濛	濛
捩	捩
皤	皤
咆	咆
女	女
蠋	蠋
岑	岑
饭	饭
试	试
啥	啥
虽	虽
扰	扰
赞	赞
燎	燎
糰	糰
脊	脊
目	目
檻	檻
湛	湛
轿	轿
咧	咧
亦	亦
瞿	瞿
晓	晓
馴	馴
赃	赃
枯	枯
鱷	鱷
臊	臊
曩	曩
猝	猝
鐮	鐮
押	押
蔥	蔥
枳	枳
鴛	鴛
莹	莹
阳	阳
揀	揀
胛	胛
伋	伋
噔	噔
毆	毆
怯	怯
眠	眠
醥	醥
粗	粗
洙	洙
偿	偿
沆	沆
椴	椴
坝	坝
耦	耦
竞	竞
煲	煲
勞	勞
憩	憩
斤	斤
择	择
甜	甜
味	味
夼	夼
括	括
盾	盾
宙	宙
駿	駿
划	划
慵	慵
桐	桐
道	道
褶	褶
杲	杲
最	最
鑿	鑿
宫	宫
帐	帐
粥	粥
點	點
褐	褐
赴	赴
搂	搂
佯	佯
很	很
衞	衞
覦	覦
茀	茀
苾	苾
苇	苇
崃	崃
城	城
杞	杞
瑊	瑊
坞	坞
禳	禳
哎	哎
笄	笄
蟊	蟊
镖	镖
雱	雱
猷	猷
珪	珪
空	空
蚕	蚕
专	专
斌	斌
臃	臃
銷	銷
豫	豫
啸	啸
办	办
擄	擄
诒	诒
狄	狄
廼	廼
憔	憔
怡	怡
弹	弹
踐	踐
煙	煙
猶	猶
掞	掞
與	與
谲	谲
曄	曄
谒	谒
佤	佤
窍	窍
嗡	嗡
谨	谨
濁	濁
颐	颐
弇	弇
么	么
杬	杬
是	是
簌	簌
廝	廝
垒	垒
湜	湜
涿	涿
統	統
抜	抜
慮	慮
猪	猪
琇	琇
業	業
踽	踽
鳣	鳣
昵	昵
暇	暇
陋	陋
畜	畜
拔	拔
帼	帼
鰭	鰭
艋	艋
冀	冀
睇	睇
涓	涓
膿	膿
縄	縄
窓	窓
群	群
闻	闻
缠	缠
鍒	鍒
菘	菘
篝	篝
囿	囿
阍	阍
跌	跌
煉	煉
典	典
敷	敷
缒	缒
秩	秩
卵	卵
奔	奔
萊	萊
酗	酗
賞	賞
魏	魏
顧	顧
変	変
侉	侉
唦	唦
竑	竑
寔	寔
鮪	鮪
馈	馈
浅	浅
喱	喱
允	允
痴	痴
椎	椎
捍	捍
杻	杻
牁	牁
餵	餵
适	适
赧	赧
鎳	鎳
剐	剐
榘	榘
釀	釀
灌	灌
誨	誨
麾	麾
渊	渊
嶽	嶽
鍰	鍰
酹	酹
餌	餌
侩	侩
唄	唄
筏	筏
捐	捐
碓	碓
癖	癖
輝	輝
釣	釣
鹈	鹈
藩	藩
唆	唆
句	句
浜	浜
釵	釵
摟	摟
谯	谯
岵	岵
稞	稞
麽	麽
務	務
舆	舆
嚏	嚏
鳍	鳍
铺	铺
愜	愜
绕	绕
巨	巨
錦	錦
瓛	瓛
弓	弓
询	询
怕	怕
綿	綿
严	严
践	践
钩	钩
遒	遒
换	换
笨	笨
擼	擼
瘍	瘍
拜	拜
祺	祺
卒	卒
查	查
抖	抖
咏	咏
馓	馓
叼	叼
壳	壳
賀	賀
頁	頁
鬣	鬣
紗	紗
攸	攸
柈	柈
儒	儒
飒	飒
菰	菰
怖	怖
蝎	蝎
諄	諄
浦	浦
哞	哞
囟	囟
援	援
翎	翎
糌	糌
靈	靈
勢	勢
証	証
舶	舶
震	震
磺	磺
幽	幽
暈	暈
鏘	鏘
舔	舔
裔	裔
倥	倥
甑	甑
燻	燻
凄	凄
窩	窩
紅	紅
縠	縠
訏	訏
俤	俤
琮	琮
鲣	鲣
歪	歪
仑	仑
祟	祟
芽	芽
惆	惆
祏	祏
佔	佔
送	送
寢	寢
仅	仅
阱	阱
眬	眬
闰	闰
贶	贶
抨	抨
肩	肩
引	引
嚒	嚒
扪	扪
殞	殞
镡	镡
固	固
嗎	嗎
樣	樣
需	需
加	加
彤	彤
樺	樺
躋	躋
砂	砂
飚	飚
瓢	瓢
褙	褙
屼	屼
列	列
盡	盡
酌	酌
傈	傈
祚	祚
镮	镮
忒	忒
战	战
趟	趟
徨	徨
诠	诠
俟	俟
娟	娟
砰	砰
嵇	嵇
志	志
褻	褻
瞒	瞒
扁	扁
傢	傢
视	视
嫔	嫔
孿	孿
箍	箍
喎	喎
钥	钥
枝	枝
蜊	蜊
殴	殴
泠	泠
任	任
謬	謬
腔	腔
殂	殂
衲	衲
赶	赶
豆	豆
尽	尽
烨	烨
骸	骸
柟	柟
馬	馬
逡	逡
急	急
婚	婚
経	経
笹	笹
轟	轟
譽	譽
噃	噃
凯	凯
炅	炅
驱	驱
鏡	鏡
鈦	鈦
芒	芒
牝	牝
颢	颢
颂	颂
佉	佉
淘	淘
铤	铤
卦	卦
擞	擞
腸	腸
谪	谪
樾	樾
倉	倉
陞	陞
碩	碩
棂	棂
製	製
卬	卬
蕎	蕎
部	部
瞭	瞭
管	管
扎	扎
棠	棠
婀	婀
圜	圜
弦	弦
镪	镪
淚	淚
喝	喝
芰	芰
稣	稣
暧	暧
詃	詃
軌	軌
录	录
狐	狐
臣	臣
粄	粄
輒	輒
哋	哋
潇	潇
啾	啾
帙	帙
師	師
贲	贲
俠	俠
陌	陌
蔵	蔵
隆	隆
玺	玺
歌	歌
镛	镛
卫	卫
妁	妁
痦	痦
衿	衿
勿	勿
喁	喁
娓	娓
莪	莪
醛	醛
霭	霭
恃	恃
彙	彙
诗	诗
毋	毋
脩	脩
邇	邇
档	档
放	放
夏	夏
強	強
围	围
愕	愕
工	工
琢	琢
際	際
郍	郍
佗	佗
埸	埸
鍾	鍾
胫	胫
茕	茕
泺	泺
娼	娼
联	联
靛	靛
瘿	瘿
昉	昉
果	果
綜	綜
瘼	瘼
媸	媸
繕	繕
馏	馏
呱	呱
槃	槃
如	如
昌	昌
珂	珂
熘	熘
谵	谵
垄	垄
綻	綻
驭	驭
小	小
膻	膻
黎	黎
稼	稼
賃	賃
玳	玳
廕	廕
乜	乜
仿	仿
擇	擇
撥	撥
贯	贯
岍	岍
士	士
園	園
祖	祖
皱	皱
偓	偓
盒	盒
狙	狙
縫	縫
夾	夾
障	障
叮	叮
悻	悻
罷	罷
昃	昃
毀	毀
灾	灾
律	律
贷	贷
壺	壺
唱	唱
冒	冒
怎	怎
柷	柷
惧	惧
沱	沱
漏	漏
浣	浣
乘	乘
氫	氫
鞠	鞠
繫	繫
储	储
成	成
诧	诧
肤	肤
椭	椭
蛇	蛇
椒	椒
賄	賄
害	害
琅	琅
蟥	蟥
枕	枕
铱	铱
舣	舣
醬	醬
圾	圾
玛	玛
象	象
脰	脰
奢	奢
歎	歎
蛭	蛭
飕	飕
蜗	蜗
甚	甚
荇	荇
炝	炝
餒	餒
獸	獸
砧	砧
絲	絲
僶	僶
鲍	鲍
鞭	鞭
缔	缔
圄	圄
立	立
雜	雜
鴨	鴨
鸡	鸡
磴	磴
橢	橢
洵	洵
棼	棼
濯	濯
狱	狱
紛	紛
黥	黥
蛉	蛉
活	活
请	请
戦	戦
唁	唁
栏	栏
棵	棵
爲	爲
皰	皰
诶	诶
羹	羹
塩	塩
雔	雔
冯	冯
鵰	鵰
掎	掎
拈	拈
舟	舟
観	観
珞	珞
段	段
夺	夺
奈	奈
蟲	蟲
宴	宴
镎	镎
於	於
痠	痠
斓	斓
勷	勷
镌	镌
哐	哐
画	画
艄	艄
銅	銅
婉	婉
栃	栃
唗	唗
砸	砸
茶	茶
値	値
皑	皑
琥	琥
孑	孑
鵴	鵴
祀	祀
孩	孩
盟	盟
贝	贝
編	編
攣	攣
纛	纛
鑾	鑾
頂	頂
擋	擋
腱	腱
蔺	蔺
流	流
呻	呻
涔	涔
榑	榑
圆	圆
巷	巷
對	對
錮	錮
棚	棚
吱	吱
恿	恿
頌	頌
萘	萘
崽	崽
娉	娉
教	教
遰	遰
唏	唏
岁	岁
铧	铧
愫	愫
梣	梣
鲻	鲻
夌	夌
嘏	嘏
沣	沣
嗅	嗅
饽	饽
臼	臼
採	採
芜	芜
嵩	嵩
淝	淝
椹	椹
绫	绫
稀	稀
薖	薖
煞	煞
至	至
榱	榱
砒	砒
腈	腈
埵	埵
鎂	鎂
靰	靰
燁	燁
牍	牍
笛	笛
鏗	鏗
蚂	蚂
绷	绷
歷	歷
佈	佈
牵	牵
魯	魯
鯽	鯽
韫	韫
答	答
饈	饈
蓝	蓝
佟	佟
妪	妪
岷	岷
溉	溉
聾	聾
邓	邓
挤	挤
泼	泼
赚	赚
挨	挨
俨	俨
柵	柵
帆	帆
橹	橹
聳	聳
辮	辮
體	體
鵲	鵲
怅	怅
编	编
垣	垣
耄	耄
吔	吔
饪	饪
嘀	嘀
绊	绊
化	化
澄	澄
閉	閉
請	請
曼	曼
堆	堆
哒	哒
馥	馥
癔	癔
梁	梁
瑀	瑀
丧	丧
鹽	鹽
蹉	蹉
遥	遥
诺	诺
霁	霁
辞	辞
少	少
諫	諫
韓	韓
礁	礁
禑	禑
挹	挹
雖	雖
蹴	蹴
付	付
肃	肃
迨	迨
鸰	鸰
昏	昏
呔	呔
啭	啭
紘	紘
秉	秉
钮	钮
肘	肘
痧	痧
諏	諏
酞	酞
卟	卟
骤	骤
鈾	鈾
睨	睨
翁	翁
榻	榻
鸽	鸽
涎	涎
嗐	嗐
騎	騎
组	组
胞	胞
牺	牺
熈	熈
咕	咕
侄	侄
宁	宁
濱	濱
铄	铄
哔	哔
亜	亜
櫥	櫥
堰	堰
無	無
淠	淠
勾	勾
閑	閑
樨	樨
漠	漠
可	可
茔	茔
谓	谓
蟄	蟄
瘁	瘁
鼾	鼾
俦	俦
骁	骁
凝	凝
悱	悱
备	备
嗨	嗨
錚	錚
紹	紹
鸪	鸪
拒	拒
诀	诀
塭	塭
蕤	蕤
痨	痨
畅	畅
劝	劝
傷	傷
桢	桢
囉	囉
俱	俱
屍	屍
江	江
馯	馯
泅	泅
聞	聞
悶	悶
恒	恒
卲	卲
淙	淙
劵	劵
娩	娩
行	行
险	险
舒	舒
播	播
维	维
滲	滲
課	課
牦	牦
孓	孓
堎	堎
呀	呀
千	千
炮	炮
苋	苋
燮	燮
锐	锐
悯	悯
腫	腫
砲	砲
閎	閎
蒼	蒼
叶	叶
禛	禛
肅	肅
煖	煖
臯	臯
孔	孔
绰	绰
牧	牧
頡	頡
窑	窑
凉	凉
综	综
酵	酵
崒	崒
郎	郎
畝	畝
狸	狸
慾	慾
脑	脑
尬	尬
鳝	鳝
黝	黝
葵	葵
脍	脍
姚	姚
処	処
麋	麋
睁	睁
轨	轨
頓	頓
洎	洎
予	予
德	德
诸	诸
啻	啻
湯	湯
黩	黩
明	明
酸	酸
昂	昂
鰍	鰍
租	租
篠	篠
岈	岈
掩	掩
軼	軼
銓	銓
鮭	鮭
荀	荀
蹿	蹿
阶	阶
瞎	瞎
開	開
炯	炯
颈	颈
声	声
骑	骑
璈	璈
拉	拉
器	器
锂	锂
歩	歩
片	片
僑	僑
垢	垢
骆	骆
料	料
籮	籮
焙	焙
臉	臉
拗	拗
瀝	瀝
没	没
榼	榼
蜃	蜃
癬	癬
碳	碳
礦	礦
栀	栀
负	负
蚝	蚝
荩	荩
螫	螫
餅	餅
踹	踹
叩	叩
篷	篷
间	间
剥	剥
棲	棲
愀	愀
棗	棗
猫	猫
冾	冾
陁	陁
楙	楙
激	激
鸣	鸣
樞	樞
恥	恥
譁	譁
数	数
辕	辕
庚	庚
瞫	瞫
阮	阮
譜	譜
嚭	嚭
宮	宮
燉	燉
励	励
顎	顎
粝	粝
者	者
窝	窝
飆	飆
瞄	瞄
鏤	鏤
翌	翌
鹗	鹗
胁	胁
澎	澎
鑰	鑰
闳	闳
敬	敬
介	介
跷	跷
贩	贩
淦	淦
峦	峦
翼	翼
啖	啖
狈	狈
俩	俩
呓	呓
驩	驩
個	個
高	高
渺	渺
艰	艰
挙	挙
摹	摹
郓	郓
戊	戊
螺	螺
蕲	蕲
硐	硐
岭	岭
欢	欢
娥	娥
卸	卸
淫	淫
节	节
遊	遊
惡	惡
跚	跚
喲	喲
幔	幔
矯	矯
黔	黔
霞	霞
皁	皁
罩	罩
螈	螈
戎	戎
猖	猖
暑	暑
傍	傍
彿	彿
厖	厖
瑣	瑣
侥	侥
繃	繃
怠	怠
榭	榭
倫	倫
嘅	嘅
惯	惯
龊	龊
噤	噤
纜	纜
輟	輟
遍	遍
旗	旗
貂	貂
处	处
鳌	鳌
抡	抡
栅	栅
窪	窪
迦	迦
約	約
覽	覽
菁	菁
鹆	鹆
河	河
瑴	瑴
莒	莒
芸	芸
祸	祸
擷	擷
藁	藁
窀	窀
龢	龢
熊	熊
撕	撕
姘	姘
懈	懈
洱	洱
勛	勛
嚣	嚣
揖	揖
靜	靜
秭	秭
旱	旱
诋	诋
恫	恫
煤	煤
领	领
撈	撈
顛	顛
盞	盞
使	使
抗	抗
楮	楮
壓	壓
杆	杆
倶	倶
仃	仃
歯	歯
沸	沸
梨	梨
今	今
思	思
偁	偁
佃	佃
懸	懸
砫	砫
哀	哀
脐	脐
霽	霽
湎	湎
髖	髖
過	過
市	市
砖	砖
嘩	嘩
膊	膊
哈	哈
盏	盏
閨	閨
镇	镇
言	言
鹮	鹮
掾	掾
诨	诨
蜚	蜚
報	報
农	农
译	译
地	地
溶	溶
咬	咬
恂	恂
瘸	瘸
钊	钊
忖	忖
凍	凍
婦	婦
汰	汰
什	什
沟	沟
踞	踞
淪	淪
觸	觸
喽	喽
醫	醫
偏	偏
庸	庸
糸	糸
摞	摞
佻	佻
泣	泣
嵋	嵋
諧	諧
轉	轉
釧	釧
纤	纤
妯	妯
僥	僥
噶	噶
糯	糯
栱	栱
蛰	蛰
担	担
筒	筒
槐	槐
壟	壟
骼	骼
柠	柠
暂	暂
庐	庐
谱	谱
麻	麻
徴	徴
叽	叽
椁	椁
睪	睪
鳞	鳞
伛	伛
镧	镧
夫	夫
跻	跻
著	著
酉	酉
熱	熱
螞	螞
僵	僵
薏	薏
龕	龕
囂	囂
仡	仡
檜	檜
戍	戍
趵	趵
鄣	鄣
履	履
赅	赅
瓤	瓤
雑	雑
接	接
寵	寵
倨	倨
裝	裝
匏	匏
鎚	鎚
咭	咭
抄	抄
桡	桡
夠	夠
槍	槍
調	調
凶	凶
箭	箭
筑	筑
熟	熟
秘	秘
痼	痼
因	因
槁	槁
籽	籽
咵	咵
窺	窺
盗	盗
氽	氽
屡	屡
搬	搬
虢	虢
皮	皮
恐	恐
杨	杨
吾	吾
尋	尋
簷	簷
滬	滬
湊	湊
匆	匆
賤	賤
樂	樂
禮	禮
鏈	鏈
鑊	鑊
璧	璧
儕	儕
钪	钪
摘	摘
锒	锒
忙	忙
甫	甫
奝	奝
翽	翽
捋	捋
盪	盪
壻	壻
叅	叅
奠	奠
鄞	鄞
蛹	蛹
犟	犟
秒	秒
佛	佛
铝	铝
缓	缓
寺	寺
酱	酱
滤	滤
坠	坠
盍	盍
绵	绵
蕴	蕴
雠	雠
哩	哩
羌	羌
簃	簃
拖	拖
噌	噌
秃	秃
齣	齣
蠡	蠡
溲	溲
锔	锔
亞	亞
缝	缝
缾	缾
约	约
弭	弭
按	按
翩	翩
遴	遴
丼	丼
甙	甙
镊	镊
霈	霈
拚	拚
鲱	鲱
浞	浞
襀	襀
鴻	鴻
嬜	嬜
稙	稙
喷	喷
籌	籌
泡	泡
円	円
鳴	鳴
箧	箧
裆	裆
鼎	鼎
判	判
呈	呈
斛	斛
荚	荚
稽	稽
膘	膘
饋	饋
贈	贈
頻	頻
逞	逞
钙	钙
畴	畴
逛	逛
窯	窯
炟	炟
亏	亏
贮	贮
轆	轆
龍	龍
氦	氦
则	则
改	改
托	托
颙	颙
猎	猎
旻	旻
丢	丢
骞	骞
珍	珍
嘌	嘌
双	双
嘲	嘲
割	割
懾	懾
汲	汲
捶	捶
豬	豬
鞣	鞣
馊	馊
蠓	蠓
职	职
蔷	蔷
娠	娠
荦	荦
黉	黉
驮	驮
冨	冨
奥	奥
睑	睑
蹂	蹂
冈	冈
俬	俬
觎	觎
摔	摔
浃	浃
代	代
麓	麓
想	想
毘	毘
陳	陳
爛	爛
褔	褔
盧	盧
皋	皋
嬌	嬌
湿	湿
赣	赣
閹	閹
饵	饵
嗒	嗒
纰	纰
鮎	鮎
闘	闘
胱	胱
基	基
提	提
住	住
藳	藳
馨	馨
贱	贱
步	步
眈	眈
窾	窾
刘	刘
旼	旼
壢	壢
従	従
薇	薇
侯	侯
痛	痛
篆	篆
缣	缣
留	留
阙	阙
仆	仆
星	星
氣	氣
濞	濞
俺	俺
寸	寸
鼓	鼓
往	往
鑣	鑣
燃	燃
筐	筐
我	我
疫	疫
昭	昭
生	生
绀	绀
翘	翘
藤	藤
崞	崞
纲	纲
哉	哉
混	混
裴	裴
翕	翕
豺	豺
瞠	瞠
胜	胜
圏	圏
悸	悸
漳	漳
郑	郑
黑	黑
忤	忤
锗	锗
镐	镐
簪	簪
啲	啲
背	背
缎	缎
醍	醍
劣	劣
鋳	鋳
钲	钲
打	打
绥	绥
蜘	蜘
澪	澪
假	假
曰	曰
潺	潺
嬖	嬖
阗	阗
龋	龋
巩	巩
镯	镯
匹	匹
拧	拧
签	签
缩	缩
枰	枰
絞	絞
偈	偈
穂	穂
鹑	鹑
恢	恢
謝	謝
軒	軒
墁	墁
掘	掘
掬	掬
吟	吟
鳟	鳟
謗	謗
驴	驴
诃	诃
億	億
浒	浒
锴	锴
壤	壤
錾	錾
镳	镳
裨	裨
處	處
蝗	蝗
癒	癒
铰	铰
袖	袖
楷	楷
螨	螨
钍	钍
蚪	蚪
桎	桎
糠	糠
龟	龟
內	內
維	維
蕐	蕐
铐	铐
嘗	嘗
嵴	嵴
遢	遢
攔	攔
珑	珑
膝	膝
看	看
餮	餮
暉	暉
竈	竈
衍	衍
墜	墜
坩	坩
寡	寡
函	函
署	署
榨	榨
諜	諜
芟	芟
扛	扛
咻	咻
彅	彅
陂	陂
玲	玲
窿	窿
挝	挝
鞘	鞘
呵	呵
拢	拢
沥	沥
骶	骶
谠	谠
扣	扣
筷	筷
脂	脂
抒	抒
屌	屌
琬	琬
艷	艷
乱	乱
鍉	鍉
亀	亀
愤	愤
讦	讦
狎	狎
孙	孙
垓	垓
竹	竹
洸	洸
穀	穀
昀	昀
亹	亹
倾	倾
厓	厓
痱	痱
贸	贸
霓	霓
娌	娌
窥	窥
忏	忏
鹀	鹀
沫	沫
綺	綺
该	该
兜	兜
洩	洩
宰	宰
裘	裘
牌	牌
涬	涬
縛	縛
喋	喋
寒	寒
磡	磡
钼	钼
恍	恍
趴	趴
犁	犁
弼	弼
何	何
况	况
蜇	蜇
憷	憷
笠	笠
瞀	瞀
车	车
锜	锜
丹	丹
鵜	鵜
嫑	嫑
馮	馮
徕	徕
妃	妃
劑	劑
嫣	嫣
瞌	瞌
掳	掳
禽	禽
鸚	鸚
蓍	蓍
一	一
俣	俣
牴	牴
價	價
張	張
爹	爹
氅	氅
纺	纺
磁	磁
毳	毳
磾	磾
嘰	嘰
薬	薬
锑	锑
窦	窦
现	现
夭	夭
厝	厝
鶴	鶴
靥	靥
椐	椐
缴	缴
骏	骏
奸	奸
袁	袁
哥	哥
筵	筵
鐘	鐘
时	时
磷	磷
袄	袄
皎	皎
矐	矐
峻	峻
存	存
嬛	嬛
仵	仵
罘	罘
鴶	鴶
碰	碰
拙	拙
舀	舀
蒙	蒙
営	営
畳	畳
烛	烛
破	破
袋	袋
痍	痍
扭	扭
姊	姊
濉	濉
从	从
西	西
别	别
统	统
奪	奪
遁	遁
魃	魃
趨	趨
窖	窖
松	松
近	近
喟	喟
肾	肾
亶	亶
伽	伽
艙	艙
畦	畦
隈	隈
貝	貝
佾	佾
摄	摄
遣	遣
蛱	蛱
黜	黜
榙	榙
祛	祛
莛	莛
匀	匀
措	措
剡	剡
缀	缀
宏	宏
邬	邬
悌	悌
胎	胎
朕	朕
潼	潼
祿	祿
咋	咋
殷	殷
序	序
信	信
勺	勺
策	策
湄	湄
枪	枪
拎	拎
亳	亳
誇	誇
驿	驿
価	価
玚	玚
珜	珜
佼	佼
郯	郯
年	年
銀	銀
研	研
智	智
竊	竊
栩	栩
讧	讧
萨	萨
鹞	鹞
瀣	瀣
阵	阵
邹	邹
冉	冉
郁	郁
稟	稟
傑	傑
束	束
鍋	鍋
杝	杝
権	権
浚	浚
垩	垩
裏	裏
哑	哑
吐	吐
栻	栻
訾	訾
末	末
蜷	蜷
瀚	瀚
聪	聪
謹	謹
感	感
岳	岳
攘	攘
茝	茝
幕	幕
鐲	鐲
賭	賭
钟	钟
风	风
肌	肌
轲	轲
藜	藜
胴	胴
讓	讓
串	串
導	導
访	访
碐	碐
墟	墟
忪	忪
婢	婢
滿	滿
収	収
嘉	嘉
槽	槽
剝	剝
冊	冊
炀	炀
妣	妣
燹	燹
欹	欹
砌	砌
黴	黴
凿	凿
簡	簡
拦	拦
蛳	蛳
驀	驀
谮	谮
妫	妫
肸	肸
槚	槚
獣	獣
穰	穰
焰	焰
彧	彧
舛	舛
恭	恭
绒	绒
史	史
堤	堤
崛	崛
褊	褊
荸	荸
矩	矩
丞	丞
瑱	瑱
锋	锋
訥	訥
痒	痒
耷	耷
薪	薪
濡	濡
鈪	鈪
豚	豚
櫾	櫾
黨	黨
夥	夥
閥	閥
脓	脓
肝	肝
淅	淅
左	左
诡	诡
淇	淇
憫	憫
鸹	鸹
浓	浓
氟	氟
榔	榔
镒	镒
跩	跩
係	係
謀	謀
賡	賡
苌	苌
秀	秀
悔	悔
郷	郷
綴	綴
覆	覆
胆	胆
擅	擅
窄	窄
貘	貘
讐	讐
煳	煳
髫	髫
咎	咎
躲	躲
粪	粪
员	员
砀	砀
禪	禪
沏	沏
蛲	蛲
洶	洶
奖	奖
僮	僮
佚	佚
灬	灬
记	记
菩	菩
後	後
演	演
炊	炊
鬃	鬃
沮	沮
璟	璟
蔭	蔭
藻	藻
锏	锏
茫	茫
蓿	蓿
砝	砝
憂	憂
蚡	蚡
梗	梗
妙	妙
丘	丘
薮	薮
罍	罍
柊	柊
蔼	蔼
伴	伴
輪	輪
棋	棋
亡	亡
泱	泱
耀	耀
上	上
货	货
詹	詹
释	释
骈	骈
眞	眞
録	録
壵	壵
鵑	鵑
雯	雯
乎	乎
逖	逖
椪	椪
穌	穌
骋	骋
描	描
钛	钛
鹄	鹄
寇	寇
菈	菈
刂	刂
嫒	嫒
拐	拐
檦	檦
茜	茜
栖	栖
楓	楓
螳	螳
唤	唤
朗	朗
阎	阎
郭	郭
衷	衷
甌	甌
启	启
叆	叆
鄢	鄢
系	系
郫	郫
攜	攜
咗	咗
廻	廻
獺	獺
兴	兴
拱	拱
实	实
股	股
穎	穎
预	预
啮	啮
命	命
川	川
屄	屄
桩	桩
飗	飗
遮	遮
麿	麿
綢	綢
皓	皓
荥	荥
驛	驛
簕	簕
蜍	蜍
歴	歴
应	应
赜	赜
涌	涌
蹼	蹼
澀	澀
莧	莧
崀	崀
猥	猥
选	选
外	外
診	診
邮	邮
莼	莼
嚟	嚟
宋	宋
汙	汙
岢	岢
傲	傲
読	読
沌	沌
娃	娃
蜓	蜓
咁	咁
迢	迢
撿	撿
诽	诽
綁	綁
袜	袜
鳳	鳳
煅	煅
玻	玻
锰	锰
巿	巿
睐	睐
龈	龈
殁	殁
未	未
圩	圩
檐	檐
氢	氢
伦	伦
技	技
犊	犊
併	併
違	違
餚	餚
逄	逄
漉	漉
旖	旖
捕	捕
嘚	嘚
止	止
綱	綱
涂	涂
碣	碣
烫	烫
瀟	瀟
攤	攤
隔	隔
俚	俚
箴	箴
牒	牒
飩	飩
角	角
奋	奋
虔	虔
纥	纥
羲	羲
茲	茲
敵	敵
誡	誡
繆	繆
頼	頼
總	總
郈	郈
橥	橥
聘	聘
硝	硝
剑	剑
淮	淮
锺	锺
鲴	鲴
桼	桼
鳃	鳃
綠	綠
稚	稚
胃	胃
埠	埠
仝	仝
蔫	蔫
疲	疲
圳	圳
带	带
社	社
菅	菅
了	了
姬	姬
蝈	蝈
萍	萍
屹	屹
田	田
糨	糨
招	招
毫	毫
髦	髦
宍	宍
过	过
机	机
钒	钒
巳	巳
颶	颶
嘔	嘔
簋	簋
斜	斜
鍊	鍊
楽	楽
舁	舁
纸	纸
税	税
情	情
炭	炭
偲	偲
叙	叙
肖	肖
胶	胶
黠	黠
嘯	嘯
氘	氘
姐	姐
状	状
额	额
镙	镙
搴	搴
頷	頷
魇	魇
繚	繚
鬢	鬢
歸	歸
碛	碛
槿	槿
熙	熙
准	准
暝	暝
泯	泯
眚	眚
缉	缉
赍	赍
阄	阄
笔	笔
莆	莆
盆	盆
勉	勉
莜	莜
玉	玉
硒	硒
叁	叁
而	而
淳	淳
艹	艹
娘	娘
渝	渝
舫	舫
蹙	蹙
籤	籤
暌	暌
芨	芨
舰	舰
闱	闱
郿	郿
席	席
邢	邢
汀	汀
稃	稃
鴕	鴕
除	除
蚯	蚯
筇	筇
鉻	鉻
祭	祭
非	非
枚	枚
嵖	嵖
络	络
竺	竺
戸	戸
饒	饒
蒺	蒺
獻	獻
俳	俳
侵	侵
騨	騨
鍥	鍥
嘜	嘜
鋐	鋐
闽	闽
喺	喺
晙	晙
好	好
慫	慫
以	以
腴	腴
爭	爭
況	況
苯	苯
熾	熾
装	装
韭	韭
親	親
矗	矗
鲠	鲠
岫	岫
暫	暫
收	收
屙	屙
泬	泬
嶄	嶄
潰	潰
麸	麸
响	响
緬	緬
腐	腐
姪	姪
滓	滓
痣	痣
仰	仰
薙	薙
旮	旮
誼	誼
吵	吵
愁	愁
斯	斯
渡	渡
椤	椤
瓷	瓷
庠	庠
鬼	鬼
讴	讴
擤	擤
齢	齢
蚌	蚌
敝	敝
男	男
域	域
豹	豹
训	训
继	继
奂	奂
舘	舘
陲	陲
花	花
綮	綮
燴	燴
弑	弑
狲	狲
爻	爻
滙	滙
蹬	蹬
矮	矮
揩	揩
柞	柞
裛	裛
彰	彰
硫	硫
邏	邏
瘩	瘩
妻	妻
济	济
桨	桨
谋	谋
蔓	蔓
邡	邡
啁	啁
痺	痺
駛	駛
翦	翦
博	博
瘙	瘙
妩	妩
校	校
頠	頠
孝	孝
述	述
簽	簽
纪	纪
塢	塢
奐	奐
拘	拘
巽	巽
媲	媲
雲	雲
罔	罔
漾	漾
迫	迫
叻	叻
蛀	蛀
锃	锃
宜	宜
跶	跶
宓	宓
闆	闆
总	总
燠	燠
痔	痔
砼	砼
镲	镲
飾	飾
鲑	鲑
說	說
瀰	瀰
支	支
門	門
武	武
諦	諦
莨	莨
詫	詫
哨	哨
粲	粲
葆	葆
蚓	蚓
埼	埼
郾	郾
尤	尤
监	监
殿	殿
埂	埂
枸	枸
耪	耪
畸	畸
罌	罌
厂	厂
错	错
仂	仂
腰	腰
蜾	蜾
萝	萝
厚	厚
賠	賠
沈	沈
颠	颠
樟	樟
馀	馀
烂	烂
樱	樱
寘	寘
惎	惎
捂	捂
誊	誊
詥	詥
汏	汏
塚	塚
隸	隸
薑	薑
圈	圈
洑	洑
様	様
云	云
霆	霆
鼷	鼷
塑	塑
妳	妳
凡	凡
惺	惺
洲	洲
茯	茯
蒿	蒿
縯	縯
含	含
诲	诲
庵	庵
徂	徂
掸	掸
峴	峴
桝	桝
誠	誠
俾	俾
骖	骖
扯	扯
苴	苴
駱	駱
眨	眨
鎖	鎖
瘗	瘗
葭	葭
倭	倭
竭	竭
习	习
悪	悪
字	字
靳	靳
靶	靶
钦	钦
捴	捴
詛	詛
稜	稜
蹭	蹭
灰	灰
蠟	蠟
厩	厩
馗	馗
毗	毗
骐	骐
濕	濕
屢	屢
鬧	鬧
鴦	鴦
雁	雁
殼	殼
玫	玫
戕	戕
侪	侪
康	康
茅	茅
咘	咘
瞇	瞇
猬	猬
闼	闼
浆	浆
偷	偷
锥	锥
摭	摭
即	即
魂	魂
嘘	嘘
亙	亙
电	电
揽	揽
髂	髂
殇	殇
禩	禩
尟	尟
彭	彭
蕙	蕙
容	容
坚	坚
繇	繇
坦	坦
凫	凫
倬	倬
堿	堿
幾	幾
燔	燔
婖	婖
萁	萁
谳	谳
谟	谟
邛	邛
迳	迳
死	死
铑	铑
並	並
郝	郝
瞧	瞧
魄	魄
苑	苑
呎	呎
科	科
隘	隘
筮	筮
戴	戴
猿	猿
蜴	蜴
瞬	瞬
頗	頗
氍	氍
刊	刊
坎	坎
刻	刻
項	項
撺	撺
镉	镉
擾	擾
楂	楂
達	達
枥	枥
范	范
迁	迁
隅	隅
驊	驊
粢	粢
襬	襬
瓣	瓣
呂	呂
癯	癯
牻	牻
殚	殚
兲	兲
桶	桶
锷	锷
涕	涕
泞	泞
湔	湔
乞	乞
襟	襟
咲	咲
水	水
繡	繡
豔	豔
衽	衽
錐	錐
籁	籁
喹	喹
減	減
稻	稻
杉	杉
蘿	蘿
莽	莽
帛	帛
痹	痹
雹	雹
謂	謂
彗	彗
殍	殍
九	九
把	把
慷	慷
萩	萩
读	读
睟	睟
離	離
俗	俗
无	无
墋	墋
忌	忌
芈	芈
丿	丿
踔	踔
李	李
嘤	嘤
輻	輻
睦	睦
溆	溆
匮	匮
冽	冽
詣	詣
軀	軀
厕	厕
责	责
芯	芯
踌	踌
芔	芔
圖	圖
瘡	瘡
鲐	鲐
鑼	鑼
馲	馲
趣	趣
苄	苄
矢	矢
螅	螅
俊	俊
昴	昴
悽	悽
瞑	瞑
蔣	蔣
倍	倍
鲲	鲲
图	图
躅	躅
桜	桜
佝	佝
棍	棍
揸	揸
汨	汨
鬚	鬚
珥	珥
卻	卻
赋	赋
碱	碱
殊	殊
您	您
锁	锁
盅	盅
匼	匼
筌	筌
恼	恼
袝	袝
嗵	嗵
盎	盎
櫛	櫛
琉	琉
悵	悵
農	農
饹	饹
払	払
鄧	鄧
啜	啜
汉	汉
坨	坨
掃	掃
痰	痰
镏	镏
鷹	鷹
蓮	蓮
叛	叛
酚	酚
渔	渔
揆	揆
膦	膦
排	排
鱼	鱼
満	満
劬	劬
詈	詈
韦	韦
灏	灏
洄	洄
亚	亚
潜	潜
癜	癜
芃	芃
銃	銃
棻	棻
徊	徊
濃	濃
椰	椰
県	県
濩	濩
芄	芄
噓	噓
瑭	瑭
庭	庭
鲔	鲔
摺	摺
罰	罰
蓆	蓆
七	七
缱	缱
葡	葡
篾	篾
軸	軸
麃	麃
斥	斥
攮	攮
衹	衹
託	託
執	執
瓦	瓦
羞	羞
犢	犢
躬	躬
穗	穗
嗄	嗄
櫃	櫃
诉	诉
壁	壁
凋	凋
朵	朵
匡	匡
倜	倜
珲	珲
但	但
塞	塞
杰	杰
溟	溟
烽	烽
盱	盱
夹	夹
誣	誣
音	音
便	便
晁	晁
庹	庹
头	头
猱	猱
红	红
狷	狷
衅	衅
暸	暸
從	從
瞪	瞪
蝮	蝮
搁	搁
迄	迄
迪	迪
饬	饬
蟹	蟹
府	府
疯	疯
谭	谭
犍	犍
限	限
蒔	蒔
璘	璘
墻	墻
洧	洧
